,codigo_tse,qt_aptos_1t_2022,qt_aptos_2t_2022,qt_comparecimento_1t_2022,qt_comparecimento_2t_2022,qt_abstencao_1t_2022,qt_abstencao_2t_2022,qt_aptos_1t_2020,qt_aptos_2t_2020,qt_comparecimento_1t_2020,qt_comparecimento_2t_2020,qt_abstencao_1t_2020,qt_abstencao_2t_2020,qt_aptos_1t_2018,qt_aptos_2t_2018,qt_comparecimento_1t_2018,qt_comparecimento_2t_2018,qt_abstencao_1t_2018,qt_abstencao_2t_2018,id_municipio
0,19,28308,28308,21083,20502,7225,7806,27740.0,,20122.0,,7618.0,,28509,28509,21155,19960,7354,8549,1100106
1,35,350576,350576,276794,271775,73782,78801,333031.0,333031.0,241180.0,219205.0,91851.0,113826.0,334529,334529,269615,259626,64914,74903,1100205
2,51,92645,92645,69829,70457,22816,22188,88732.0,,62074.0,,26658.0,,85978,85978,67990,66720,17988,19258,1100122
3,78,70026,70026,51703,52062,18323,17964,66872.0,,45411.0,,21461.0,,66945,66945,50792,49061,16153,17884,1100023
4,94,66611,66611,51168,52070,15443,14541,63487.0,,45785.0,,17702.0,,60905,60905,49940,48952,10965,11953,1100049
5,116,26482,26482,20393,20623,6089,5859,25416.0,,18219.0,,7197.0,,26269,26269,21260,20721,5009,5548,1100189
6,132,65655,65655,50143,51034,15512,14621,61182.0,,44704.0,,16478.0,,60464,60464,47735,48138,12729,12326,1100304
7,159,43093,43093,30073,30490,13020,12603,42758.0,,30193.0,,12565.0,,40137,40137,28410,27291,11727,12846,1100114
8,175,30386,30386,20985,21182,9401,9204,30390.0,,20712.0,,9678.0,,29469,29469,20706,19696,8763,9773,1100155
9,191,15609,15609,11532,11659,4077,3950,15389.0,,11257.0,,4132.0,,14813,14813,11912,11610,2901,3203,1100254
10,213,9506,9506,6884,6817,2622,2689,9364.0,,6761.0,,2603.0,,8828,8828,6334,5964,2494,2864,1100080
11,230,13774,13774,10013,10263,3761,3511,13510.0,,9645.0,,3865.0,,13734,13734,10270,10092,3464,3642,1100064
12,256,23901,23901,18242,18420,5659,5481,23496.0,,17121.0,,6375.0,,23293,23293,18799,18344,4494,4949,1100098
13,272,12945,12945,10044,10143,2901,2802,12546.0,,9534.0,,3012.0,,12238,12238,10128,9939,2110,2299,1100056
14,299,40573,40573,29957,30682,10616,9891,39338.0,,27337.0,,12001.0,,38258,38258,30906,30395,7352,7863,1100288
15,310,19396,19396,14080,14184,5316,5212,19478.0,,14015.0,,5463.0,,18789,18789,13451,13094,5338,5695,1100015
16,337,11874,11874,8316,8545,3558,3329,11941.0,,8654.0,,3287.0,,12144,12144,8405,8134,3739,4010,1100346
17,353,6834,6834,4918,5048,1916,1786,6757.0,,5320.0,,1437.0,,6443,6443,5273,5112,1170,1331,1100296
18,370,14087,14087,10520,10652,3567,3435,14097.0,,10204.0,,3893.0,,14059,14059,10378,10194,3681,3865,1100148
19,396,23659,23659,16549,16661,7110,6998,22666.0,,15559.0,,7107.0,,23091,23091,16345,15016,6746,8075,1100130
20,418,17415,17415,12954,12992,4461,4423,17465.0,,12742.0,,4723.0,,16478,16478,12097,11791,4381,4687,1100320
21,434,17984,17984,13382,13384,4602,4600,17335.0,,12626.0,,4709.0,,17004,17004,12830,12045,4174,4959,1100338
22,450,4770,4770,3581,3610,1189,1160,4681.0,,3774.0,,907.0,,4605,4605,3609,3497,996,1108,1100031
23,477,18884,18884,13693,13338,5191,5546,18023.0,,13288.0,,4735.0,,17683,17683,13262,12402,4421,5281,1100809
24,493,6442,6442,4561,4506,1881,1936,6397.0,,4564.0,,1833.0,,6520,6520,4736,4395,1784,2125,1101104
25,515,6838,6838,5437,5450,1401,1388,6700.0,,5431.0,,1269.0,,6610,6610,5733,5561,877,1049,1100502
26,531,3077,3077,2297,2287,780,790,3116.0,,2471.0,,645.0,,3065,3065,2338,2251,727,814,1100908
27,558,6187,6187,4452,4461,1735,1726,6202.0,,4732.0,,1470.0,,6418,6418,4665,4312,1753,2106,1101807
28,566,9547,9547,6822,6866,2725,2681,9749.0,,7182.0,,2567.0,,9293,9293,6607,6447,2686,2846,1101708
29,574,9142,9142,6531,6533,2611,2609,9156.0,,6753.0,,2403.0,,8784,8784,6343,6100,2441,2684,1101302
30,582,10062,10062,7398,7419,2664,2643,9997.0,,7493.0,,2504.0,,9138,9138,6725,6497,2413,2641,1101500
31,590,8022,8022,5799,5722,2223,2300,8175.0,,6217.0,,1958.0,,8303,8303,6017,5527,2286,2776,1101609
32,604,5996,5996,4629,4682,1367,1314,6115.0,,4914.0,,1201.0,,5727,5727,4817,4645,910,1082,1101203
33,612,7384,7384,5380,5292,2004,2092,7559.0,,5843.0,,1716.0,,7402,7402,5252,4854,2150,2548,1101005
34,620,3934,3934,2976,2987,958,947,3963.0,,3122.0,,841.0,,3933,3933,3030,2863,903,1070,1100601
35,639,11716,11716,8598,8584,3118,3132,11766.0,,8640.0,,3126.0,,11942,11942,8970,8443,2972,3499,1100403
36,647,3320,3320,2387,2399,933,921,3412.0,,2644.0,,768.0,,3043,3043,2305,2095,738,948,1100262
37,655,5612,5612,4396,4354,1216,1258,5612.0,,4516.0,,1096.0,,5607,5607,4734,4489,873,1118,1100072
38,663,10069,10069,7290,7252,2779,2817,9949.0,,7134.0,,2815.0,,9889,9889,7257,6936,2632,2953,1101401
39,671,7750,7750,5567,5569,2183,2181,7773.0,,5491.0,,2282.0,,7980,7980,6021,5735,1959,2245,1100700
40,680,11101,11101,7903,7715,3198,3386,10544.0,,7755.0,,2789.0,,10694,10694,7660,7155,3034,3539,1100940
41,698,6390,6390,4747,4698,1643,1692,6335.0,,4817.0,,1518.0,,6225,6225,4701,4296,1524,1929,1101757
42,701,3261,3261,2482,2385,779,876,3279.0,,2687.0,,592.0,,3073,3073,2499,2365,574,708,1101450
43,710,4431,4431,3416,3532,1015,899,4376.0,,3643.0,,733.0,,4372,4372,3644,3539,728,833,1101484
44,728,2872,2872,2260,2271,612,601,2803.0,,2216.0,,587.0,,2773,2773,2209,2105,564,668,1101476
45,736,8354,8354,6463,6508,1891,1846,8093.0,,6390.0,,1703.0,,8097,8097,6716,6565,1381,1532,1100379
46,744,5571,5571,4137,4185,1434,1386,5564.0,,4227.0,,1337.0,,5647,5647,4161,4034,1486,1613,1101435
47,752,4091,4091,3049,3071,1042,1020,4110.0,,3192.0,,918.0,,4164,4164,3074,2986,1090,1178,1101559
48,779,22970,22970,15876,16133,7094,6837,22608.0,,14804.0,,7804.0,,23065,23065,16517,16008,6548,7057,1100452
49,787,1988,1988,1509,1467,479,521,1944.0,,1642.0,,302.0,,1747,1747,1477,1341,270,406,1101468
50,795,12555,12555,9377,9317,3178,3238,12248.0,,9342.0,,2906.0,,11085,11085,8516,8068,2569,3017,1101492
51,809,7312,7312,5114,5041,2198,2271,7266.0,,5522.0,,1744.0,,6472,6472,5116,4894,1356,1578,1100924
52,1007,9941,9941,7525,6839,2416,3102,9613.0,,7387.0,,2226.0,,8683,8683,6992,6198,1691,2485,1200138
53,1015,7843,7843,6172,5555,1671,2288,7540.0,,6108.0,,1432.0,,6832,6832,5854,5135,978,1697,1200179
54,1023,13195,13195,10592,9893,2603,3302,12639.0,,10026.0,,2613.0,,12299,12299,10384,9517,1915,2782,1200807
55,1031,3771,3771,2612,2421,1159,1350,3566.0,,2992.0,,574.0,,3316,3316,2331,1913,985,1403,1200435
56,1040,11337,11337,8257,6602,3080,4735,10491.0,,8616.0,,1875.0,,9530,9530,7051,5202,2479,4328,1200351
57,1058,18230,18230,14567,13822,3663,4408,16844.0,,13522.0,,3322.0,,16041,16041,13445,12325,2596,3716,1200104
58,1066,7214,7214,5637,4089,1577,3125,6570.0,,5658.0,,912.0,,6075,6075,4636,3202,1439,2873,1200393
59,1074,59505,59505,46952,43030,12553,16475,55749.0,,44533.0,,11216.0,,54600,54600,45684,40885,8916,13715,1200203
60,1082,11784,11784,9087,7581,2697,4203,11388.0,,9303.0,,2085.0,,11001,11001,8522,6689,2479,4312,1200427
61,1090,13786,13786,10580,9239,3206,4547,13141.0,,10964.0,,2177.0,,12429,12429,9749,7861,2680,4568,1200336
62,1104,5594,5594,4145,3503,1449,2091,5209.0,,4308.0,,901.0,,4793,4793,3579,2864,1214,1929,1200328
63,1112,12531,12531,9952,9389,2579,3142,11732.0,,9447.0,,2285.0,,10770,10770,9237,8585,1533,2185,1200252
64,1120,9529,9529,7297,6925,2232,2604,9169.0,,7093.0,,2076.0,,8809,8809,7260,6698,1549,2111,1200013
65,1139,22789,22789,15891,14002,6898,8787,21561.0,,16218.0,,5343.0,,20565,20565,14591,12003,5974,8562,1200302
66,1392,266883,266883,210912,202291,55971,64592,256673.0,256673.0,186769.0,174249.0,69904.0,82424.0,255548,255548,212014,200867,43534,54681,1200401
67,1457,30369,30369,22510,19017,7859,11352,28985.0,,22382.0,,6603.0,,28328,28328,20547,16305,7781,12023,1200500
68,1473,27701,27701,19387,16412,8314,11289,26354.0,,19649.0,,6705.0,,25576,25576,18226,14114,7350,11462,1200609
69,1490,12127,12127,9710,9091,2417,3036,11399.0,,9228.0,,2171.0,,11400,11400,9568,8638,1832,2762,1200708
70,1511,12286,12286,9694,8695,2592,3591,11964.0,,9823.0,,2141.0,,11461,11461,9914,8745,1547,2716,1200385
71,1538,17851,17851,14246,13206,3605,4645,17552.0,,14140.0,,3412.0,,17105,17105,14606,13231,2499,3874,1200450
72,1554,7779,7779,5765,5059,2014,2720,7209.0,,5716.0,,1493.0,,6793,6793,4931,4103,1862,2690,1200344
73,1570,6388,6388,5018,4710,1370,1678,5913.0,,4918.0,,995.0,,5726,5726,4592,4135,1134,1591,1200054
74,2003,11716,11716,7959,8038,3757,3678,10558.0,,7702.0,,2856.0,,10674,10674,6982,6818,3692,3856,1300144
75,2011,11516,11516,8921,8267,2595,3249,10748.0,,9012.0,,1736.0,,10290,10290,7585,7871,2705,2419,1303205
76,2020,11839,11839,7994,7696,3845,4143,11307.0,,8811.0,,2496.0,,9532,9532,6411,6130,3121,3402,1301654
77,2038,10845,10845,8239,7462,2606,3383,10266.0,,8693.0,,1573.0,,9724,9724,7272,6335,2452,3389,1300102
78,2046,16774,16774,13051,11781,3723,4993,15775.0,,13308.0,,2467.0,,15290,15290,12283,10759,3007,4531,1301159
79,2054,9046,9046,6275,6179,2771,2867,8602.0,,6914.0,,1688.0,,7930,7930,5430,5176,2500,2754,1300201
80,2070,28953,28953,21983,20157,6970,8796,26365.0,,22322.0,,4043.0,,25296,25296,19855,18069,5441,7227,1300300
81,2097,11837,11837,7586,7550,4251,4287,11301.0,,8588.0,,2713.0,,10506,10506,6583,5908,3923,4598,1300409
82,2119,21126,21126,16789,16100,4337,5026,20100.0,,16577.0,,3523.0,,18318,18318,13993,13340,4325,4978,1300508
83,2135,22308,22308,16989,17015,5319,5293,21269.0,,17248.0,,4021.0,,20448,20448,15738,15245,4710,5203,1300607
84,2151,23042,23042,16280,16512,6762,6530,22558.0,,17327.0,,5231.0,,20977,20977,14767,14216,6210,6761,1300706
85,2178,20957,20957,16630,16430,4327,4527,22473.0,,18305.0,,4168.0,,20306,20306,14522,13762,5784,6544,1300805
86,2194,10086,10086,7051,6897,3035,3189,9238.0,,7441.0,,1797.0,,8375,8375,5623,5426,2752,2949,1300904
87,2216,21605,21605,14137,14782,7468,6823,20626.0,,15415.0,,5211.0,,19350,19350,12082,12781,7268,6569,1301001
88,2232,24256,24256,17599,16530,6657,7726,22649.0,,18671.0,,3978.0,,21052,21052,16188,14779,4864,6273,1301100
89,2259,51739,51739,36086,34500,15653,17239,49702.0,,38815.0,,10887.0,,50320,50320,35780,33547,14540,16773,1301209
90,2275,16506,16506,11954,11099,4552,5407,15680.0,,12572.0,,3108.0,,14438,14438,9894,8973,4544,5465,1301308
91,2291,20144,20144,14608,15233,5536,4911,22381.0,,16453.0,,5928.0,,20769,20769,13032,13143,7737,7626,1301407
92,2313,12125,12125,7566,7612,4559,4513,11528.0,,8211.0,,3317.0,,11453,11453,6351,6882,5102,4571,1301506
93,2330,16488,16488,11800,11579,4688,4909,15485.0,,12724.0,,2761.0,,14879,14879,10061,10047,4818,4832,1301605
94,2356,32902,32902,24443,24301,8459,8601,31604.0,,24800.0,,6804.0,,28568,28568,20121,19173,8447,9395,1301704
95,2372,8946,8946,5603,5317,3343,3629,8353.0,,5936.0,,2417.0,,7957,7957,4563,4335,3394,3622,1303601
96,2399,11984,11984,7752,7760,4232,4224,11608.0,,9201.0,,2407.0,,10772,10772,7014,6988,3758,3784,1301803
97,2410,71241,71241,55012,51666,16229,19575,67270.0,,53035.0,,14235.0,,66385,66385,51332,47664,15053,18721,1301902
98,2437,8357,8357,6465,6245,1892,2112,7873.0,,6828.0,,1045.0,,7230,7230,5459,4906,1771,2324,1302009
99,2453,5149,5149,3438,3114,1711,2035,4771.0,,3908.0,,863.0,,4455,4455,2937,2770,1518,1685,1302108
100,2470,7915,7915,5362,5055,2553,2860,7577.0,,5867.0,,1710.0,,7136,7136,4445,4455,2691,2681,1302207
101,2496,14371,14371,9544,9799,4827,4572,13329.0,,10896.0,,2433.0,,12412,12412,8072,8074,4340,4338,1302306
102,2518,27161,27161,19213,18888,7948,8273,25441.0,,19481.0,,5960.0,,24266,24266,16579,16063,7687,8203,1302405
103,2534,72802,72802,57672,54753,15130,18049,67504.0,,55924.0,,11580.0,,66014,66014,52338,48309,13676,17705,1302504
104,2550,1415958,1415958,1200210,1188538,215748,227420,1331613.0,1331613.0,1088826.0,1032901.0,242787.0,298712.0,1320059,1320059,1152721,1143094,167338,176965,1302603
105,2577,33205,33205,24583,24066,8622,9139,30846.0,,24278.0,,6568.0,,28013,28013,19297,18583,8716,9430,1302702
106,2593,10148,10148,6147,5553,4001,4595,9616.0,,7582.0,,2034.0,,9620,9620,5628,5253,3992,4367,1302801
107,2615,36977,36977,27401,25782,9576,11195,34283.0,,26936.0,,7347.0,,30959,30959,21983,20659,8976,10300,1302900
108,2631,14389,14389,11209,10822,3180,3567,13843.0,,11927.0,,1916.0,,13080,13080,9548,9096,3532,3984,1303007
109,2658,19088,19088,14349,13501,4739,5587,18265.0,,14619.0,,3646.0,,16906,16906,12060,11100,4846,5806,1303106
110,2674,13708,13708,9477,9301,4231,4407,13070.0,,10338.0,,2732.0,,12347,12347,8256,7817,4091,4530,1303304
111,2690,72964,72964,55341,52488,17623,20476,69583.0,,52202.0,,17381.0,,68263,68263,51603,49771,16660,18492,1303403
112,2712,11419,11419,7736,7416,3683,4003,10681.0,,8300.0,,2381.0,,10224,10224,6543,6477,3681,3747,1303502
113,2739,16370,16370,12787,12721,3583,3649,15154.0,,13112.0,,2042.0,,13907,13907,10584,10387,3323,3520,1303700
114,2755,18566,18566,14942,14870,3624,3696,17604.0,,15225.0,,2379.0,,16924,16924,13587,13353,3337,3571,1303908
115,2771,8330,8330,6520,6072,1810,2258,7561.0,,6425.0,,1136.0,,7169,7169,5609,4996,1560,2173,1304005
116,2798,14068,14068,9753,9153,4315,4915,13143.0,,10689.0,,2454.0,,12725,12725,8589,8201,4136,4524,1304104
117,2810,42096,42096,34093,33302,8003,8794,44504.0,,35075.0,,9429.0,,41032,41032,30191,28902,10841,12130,1304203
118,2836,32106,32106,21709,22005,10397,10101,31185.0,,22938.0,,8247.0,,29195,29195,18951,18051,10244,11144,1303809
119,2852,12284,12284,9013,8601,3271,3683,11723.0,,9779.0,,1944.0,,11577,11577,8451,7725,3126,3852,1304302
120,2879,13201,13201,9791,9252,3410,3949,12592.0,,10491.0,,2101.0,,12212,12212,8920,8051,3292,4161,1304401
121,2895,11366,11366,8717,8474,2649,2892,10876.0,,9169.0,,1707.0,,9770,9770,7255,7041,2515,2729,1300029
122,2917,6814,6814,5424,5403,1390,1411,6432.0,,5559.0,,873.0,,5910,5910,4675,4614,1235,1296,1300060
123,2933,8676,8676,6487,6041,2189,2635,8098.0,,6776.0,,1322.0,,7452,7452,5554,6191,1898,1261,1300086
124,2950,13842,13842,10438,9015,3404,4827,12916.0,,10995.0,,1921.0,,11755,11755,8835,7985,2920,3770,1300631
125,2976,12727,12727,9708,9267,3019,3460,11667.0,,9795.0,,1872.0,,10837,10837,8000,7827,2837,3010,1300680
126,2992,9630,9630,7133,6235,2497,3395,8966.0,,7473.0,,1493.0,,8152,8152,5904,5172,2248,2980,1300839
127,3000,6496,6496,5646,5260,850,1236,5841.0,,5051.0,,790.0,,5639,5639,5117,4702,522,937,1400233
128,3018,232392,232392,192275,185739,40117,46653,217477.0,217477.0,165428.0,149223.0,52049.0,68254.0,218304,218304,184591,177959,33713,40345,1400100
129,3026,5757,5757,4988,4342,769,1415,5328.0,,4500.0,,828.0,,5025,5025,4458,3927,567,1098,1400282
130,3034,14175,14175,11703,10002,2472,4173,13468.0,,11061.0,,2407.0,,12489,12489,10859,9370,1630,3119,1400209
131,3042,6521,6521,5620,4744,901,1777,6019.0,,5172.0,,847.0,,5716,5716,5276,4686,440,1030,1400027
132,3050,10932,10932,9311,8274,1621,2658,10525.0,,8884.0,,1641.0,,9537,9537,8641,7641,896,1896,1400050
133,3069,13377,13377,11314,9934,2063,3443,12894.0,,10768.0,,2126.0,,11001,11001,9901,9042,1100,1959,1400175
134,3077,10221,10221,8661,7688,1560,2533,9665.0,,8211.0,,1454.0,,8379,8379,7608,6907,771,1472,1400159
135,3085,20516,20516,16698,15082,3818,5434,18775.0,,14815.0,,3960.0,,17533,17533,15116,13784,2417,3749,1400472
136,3093,12464,12464,10450,9582,2014,2882,11929.0,,9968.0,,1961.0,,11227,11227,9759,8899,1468,2328,1400308
137,3107,6333,6333,5537,5265,796,1068,5708.0,,5040.0,,668.0,,5411,5411,4874,4767,537,644,1400704
138,3115,7661,7661,6692,6108,969,1553,6912.0,,6141.0,,771.0,,6395,6395,5926,5641,469,754,1400407
139,3123,8454,8454,6825,6090,1629,2364,8133.0,,6316.0,,1817.0,,7573,7573,6686,6131,887,1442,1400456
140,3131,4948,4948,4274,3773,674,1175,4581.0,,3980.0,,601.0,,4352,4352,3878,3463,474,889,1400506
141,3158,5993,5993,5066,4043,927,1950,5396.0,,4647.0,,749.0,,4883,4883,4334,3642,549,1241,1400605
142,4006,22448,22448,16299,15609,6149,6839,21409.0,,16136.0,,5273.0,,22305,22305,15410,13938,6895,8367,1503093
143,4014,119594,119594,99959,99570,19635,20024,113661.0,,95032.0,,18629.0,,107335,107335,90590,87618,16745,19717,1500107
144,4022,52878,52878,40341,39797,12537,13081,51187.0,,40500.0,,10687.0,,47134,47134,35385,32871,11749,14263,1507953
145,4030,44113,44113,37642,36557,6471,7556,40802.0,,36177.0,,4625.0,,38347,38347,34592,33066,3755,5281,1500206
146,4049,10901,10901,8713,8572,2188,2329,9952.0,,8538.0,,1414.0,,9491,9491,8276,7856,1215,1635,1501576
147,4057,27075,27075,21226,19392,5849,7683,25663.0,,21675.0,,3988.0,,24079,24079,18794,17978,5285,6101,1500305
148,4065,17623,17623,13727,12813,3896,4810,16655.0,,13817.0,,2838.0,,16297,16297,12896,11645,3401,4652,1507474
149,4073,40975,40975,33153,32211,7822,8764,37528.0,,31527.0,,6001.0,,35785,35785,30744,29490,5041,6295,1500404
150,4081,28567,28567,20380,20296,8187,8271,27669.0,,20517.0,,7152.0,,26774,26774,18879,18005,7895,8769,1508084
151,4090,23689,23689,17745,16715,5944,6974,23160.0,,18641.0,,4519.0,,22090,22090,16510,15037,5580,7053,1500503
152,4103,26178,26178,19568,19313,6610,6865,25688.0,,19827.0,,5861.0,,24804,24804,18511,17463,6293,7341,1504059
153,4111,89576,89576,65323,65345,24253,24231,86463.0,,62118.0,,24345.0,,79834,79834,59681,57843,20153,21991,1500602
154,4120,20707,20707,14974,14871,5733,5836,20667.0,,16130.0,,4537.0,,19174,19174,13726,12797,5448,6377,1502954
155,4138,21578,21578,15825,14582,5753,6996,20303.0,,16202.0,,4101.0,,19034,19034,13248,12254,5786,6780,1500701
156,4146,17997,17997,13814,13244,4183,4753,17036.0,,13790.0,,3246.0,,16162,16162,12089,11236,4073,4926,1506559
157,4154,348936,348936,287990,285793,60946,63143,330014.0,,262938.0,,67076.0,,322428,322428,276860,269445,45568,52983,1500800
158,4162,5588,5588,4617,4444,971,1144,5177.0,,4569.0,,608.0,,4938,4938,4368,4227,570,711,1505494
159,4170,35887,35887,28862,27093,7025,8794,32787.0,,28113.0,,4674.0,,31370,31370,26965,25075,4405,6295,1500909
160,4189,24113,24113,17820,17344,6293,6769,23827.0,,19183.0,,4644.0,,19296,19296,14126,13265,5170,6031,1503457
161,4197,11645,11645,8275,7594,3370,4051,10752.0,,8363.0,,2389.0,,10423,10423,7291,6303,3132,4120,1501006
162,4200,13285,13285,9009,8699,4276,4586,12073.0,,9009.0,,3064.0,,10276,10276,6452,6259,3824,4017,1503754
163,4219,15997,15997,11923,10599,4074,5398,14935.0,,12317.0,,2618.0,,13642,13642,9487,8257,4155,5385,1501105
164,4227,15183,15183,12198,12468,2985,2715,14441.0,,12137.0,,2304.0,,13794,13794,11843,11740,1951,2054,1501725
165,4235,26547,26547,21205,20209,5342,6338,24831.0,,21013.0,,3818.0,,23547,23547,18985,17512,4562,6035,1501204
166,4243,17198,17198,13835,13578,3363,3620,16340.0,,13905.0,,2435.0,,16064,16064,14382,13935,1682,2129,1506351
167,4251,94687,94687,77908,76670,16779,18017,88274.0,,73004.0,,15270.0,,84369,84369,70625,67947,13744,16422,1501303
168,4260,9799,9799,7641,7683,2158,2116,9344.0,,8157.0,,1187.0,,7467,7467,6447,6284,1020,1183,1500347
169,4278,1065620,1065620,883367,888117,182253,177503,1009731.0,1009731.0,800140.0,800009.0,209591.0,209722.0,990866,990866,871167,869474,119699,121392,1501402
170,4286,11909,11909,8584,8324,3325,3585,11300.0,,8703.0,,2597.0,,10383,10383,7261,6684,3122,3699,1508050
171,4294,46906,46906,38157,37586,8749,9320,44925.0,,37046.0,,7879.0,,40098,40098,33055,32175,7043,7923,1501501
172,4308,7754,7754,5531,5303,2223,2451,7701.0,,6025.0,,1676.0,,7055,7055,4953,4358,2102,2697,1505551
173,4316,12200,12200,10162,9732,2038,2468,11736.0,,10360.0,,1376.0,,10941,10941,9359,8924,1582,2017,1501600
174,4324,20022,20022,14947,14639,5075,5383,18985.0,,15093.0,,3892.0,,17066,17066,12369,11774,4697,5292,1508126
175,4332,89469,89469,70559,68074,18910,21395,83478.0,,67338.0,,16140.0,,80857,80857,66973,63306,13884,17551,1501709
176,4340,19140,19140,14190,13803,4950,5337,18846.0,,15060.0,,3786.0,,17790,17790,13234,12504,4556,5286,1500958
177,4359,73834,73834,55011,50195,18823,23639,69352.0,,54468.0,,14884.0,,62720,62720,45086,39796,17634,22924,1501808
178,4367,14678,14678,10957,10691,3721,3987,13954.0,,11613.0,,2341.0,,13206,13206,9818,9522,3388,3684,1507979
179,4375,21665,21665,17929,17407,3736,4258,20940.0,,17951.0,,2989.0,,19445,19445,15957,14914,3488,4531,1501907
180,4383,23927,23927,16418,16935,7509,6992,22649.0,,15751.0,,6898.0,,19910,19910,13225,12785,6685,7125,1505031
181,4391,18845,18845,14389,13712,4456,5133,17734.0,,14381.0,,3353.0,,17250,17250,13084,11789,4166,5461,1502004
182,4405,14736,14736,11641,11291,3095,3445,13782.0,,11575.0,,2207.0,,11828,11828,10232,9545,1596,2283,1508357
183,4413,100371,100371,83950,81698,16421,18673,93166.0,,79213.0,,13953.0,,89067,89067,74313,70007,14754,19060,1502103
184,4421,45781,45781,33371,32823,12410,12958,43140.0,,33567.0,,9573.0,,40473,40473,28867,26189,11606,14284,1505064
185,4430,53160,53160,43274,42519,9886,10641,50682.0,,41040.0,,9642.0,,50068,50068,41013,39314,9055,10754,1502202
186,4448,33469,33469,23156,22204,10313,11265,32856.0,,24408.0,,8448.0,,32489,32489,22561,20707,9928,11782,1501782
187,4456,41036,41036,34212,33181,6824,7855,39091.0,,33644.0,,5447.0,,38234,38234,32227,29967,6007,8267,1502301
188,4464,17084,17084,12165,12159,4919,4925,16660.0,,12732.0,,3928.0,,15788,15788,11117,10586,4671,5202,1507151
189,4472,138488,138488,115062,114883,23426,23605,129958.0,,105384.0,,24574.0,,128121,128121,107490,105724,20631,22397,1502400
190,4480,16200,16200,12291,11833,3909,4367,15847.0,,13134.0,,2713.0,,14402,14402,10954,10021,3448,4381,1504950
191,4499,14514,14514,10290,9397,4224,5117,13298.0,,10964.0,,2334.0,,12360,12360,10094,9077,2266,3283,1502509
192,4502,5470,5470,4247,4242,1223,1228,5331.0,,4680.0,,651.0,,5005,5005,4285,4196,720,809,1500131
193,4510,11450,11450,9196,8460,2254,2990,10815.0,,9027.0,,1788.0,,10062,10062,8062,7011,2000,3051,1502608
194,4529,7170,7170,5416,5220,1754,1950,6577.0,,5677.0,,900.0,,4899,4899,4011,3898,888,1001,1502764
195,4537,33410,33410,24688,24829,8722,8581,32215.0,,24915.0,,7300.0,,31508,31508,24453,24037,7055,7471,1502707
196,4545,10800,10800,8550,8277,2250,2523,10564.0,,8929.0,,1635.0,,10159,10159,8217,7652,1942,2507,1507961
197,4553,23461,23461,18602,17587,4859,5874,21900.0,,18553.0,,3347.0,,20334,20334,15544,14182,4790,6152,1502806
198,4561,14097,14097,10909,10563,3188,3534,13560.0,,11296.0,,2264.0,,12795,12795,10185,9946,2610,2849,1503044
199,4570,33635,33635,26529,25189,7106,8446,31029.0,,24848.0,,6181.0,,30324,30324,24336,22422,5988,7902,1502905
200,4588,2948,2948,2220,2172,728,776,2876.0,,2464.0,,412.0,,2393,2393,1987,1920,406,473,1501253
201,4596,6892,6892,5102,4793,1790,2099,6449.0,,5494.0,,955.0,,5857,5857,4266,4032,1591,1825,1503002
202,4600,10293,10293,8363,8073,1930,2220,9926.0,,8611.0,,1315.0,,9059,9059,7906,7606,1153,1453,1504976
203,4618,21679,21679,17645,16362,4034,5317,19911.0,,16942.0,,2969.0,,18033,18033,13695,12935,4338,5098,1503101
204,4626,13670,13670,10530,10422,3140,3248,12793.0,,10374.0,,2419.0,,11571,11571,8523,8005,3048,3566,1505650
205,4634,31555,31555,25266,25000,6289,6555,30139.0,,24524.0,,5615.0,,29482,29482,23897,22921,5585,6561,1503200
206,4642,84772,84772,69879,68911,14893,15861,77810.0,,65435.0,,12375.0,,73289,73289,63369,61380,9920,11909,1504422
207,4650,51326,51326,41733,40079,9593,11247,48670.0,,40577.0,,8093.0,,46539,46539,37224,34141,9315,12398,1503309
208,4669,24364,24364,19436,18692,4928,5672,23247.0,,19509.0,,3738.0,,22802,22802,19042,17924,3760,4878,1508035
209,4677,8891,8891,7694,7450,1197,1441,8402.0,,7546.0,,856.0,,8198,8198,7411,7129,787,1069,1503408
210,4685,10208,10208,7526,7134,2682,3074,9803.0,,7811.0,,1992.0,,9414,9414,7244,6520,2170,2894,1506112
211,4693,26859,26859,21148,20459,5711,6400,25742.0,,20944.0,,4798.0,,24850,24850,19501,18407,5349,6443,1503507
212,4707,49064,49064,36578,37007,12486,12057,40583.0,,31920.0,,8663.0,,39855,39855,27000,25981,12855,13874,1502152
213,4715,87719,87719,60348,58688,27371,29031,83975.0,,57574.0,,26401.0,,77134,77134,51759,48084,25375,29050,1503606
214,4723,22309,22309,16665,16075,5644,6234,21807.0,,17463.0,,4344.0,,17144,17144,12849,12078,4295,5066,1500859
215,4731,34023,34023,24374,23488,9649,10535,33035.0,,24761.0,,8274.0,,32458,32458,22676,20605,9782,11853,1503705
216,4740,10441,10441,8841,8460,1600,1981,9391.0,,8378.0,,1013.0,,8765,8765,7771,7498,994,1267,1502855
217,4758,34419,34419,25014,24333,9405,10086,34460.0,,25969.0,,8491.0,,34284,34284,24471,22303,9813,11981,1503804
218,4766,14860,14860,10850,10196,4010,4664,14219.0,,11133.0,,3086.0,,13331,13331,9652,8821,3679,4510,1501956
219,4774,36904,36904,29272,28536,7632,8368,34537.0,,28388.0,,6149.0,,31773,31773,24318,23165,7455,8608,1503903
220,4782,10066,10066,7300,6943,2766,3123,9739.0,,7476.0,,2263.0,,9165,9165,6308,5802,2857,3363,1505635
221,4790,22051,22051,18348,17613,3703,4438,20464.0,,18084.0,,2380.0,,19536,19536,15531,14933,4005,4603,1504000
222,4804,15087,15087,12267,11982,2820,3105,14200.0,,11751.0,,2449.0,,13757,13757,11392,10962,2365,2795,1501451
223,4812,8409,8409,6712,6121,1697,2288,8075.0,,6865.0,,1210.0,,7833,7833,6290,5512,1543,2321,1504109
224,4820,5910,5910,4934,4576,976,1334,5482.0,,4806.0,,676.0,,5203,5203,4532,4241,671,962,1507466
225,4839,185129,185129,142315,142038,42814,43091,179714.0,,136777.0,,42937.0,,162409,162409,125012,120047,37397,42362,1504208
226,4847,4856,4856,3717,3531,1139,1325,4667.0,,4061.0,,606.0,,3917,3917,3312,3110,605,807,1507755
227,4855,25327,25327,20955,19586,4372,5741,23571.0,,20731.0,,2840.0,,22422,22422,19806,18532,2616,3890,1504307
228,4863,20289,20289,16121,15869,4168,4420,18977.0,,15290.0,,3687.0,,18259,18259,14820,14143,3439,4116,1504752
229,4871,23353,23353,19173,17724,4180,5629,21543.0,,18454.0,,3089.0,,20641,20641,18091,16353,2550,4288,1504406
230,4898,17874,17874,12817,12033,5057,5841,16995.0,,13806.0,,3189.0,,15903,15903,10508,8748,5395,7155,1504505
231,4910,27223,27223,21947,21200,5276,6023,25361.0,,21565.0,,3796.0,,23775,23775,19053,17856,4722,5919,1504604
232,4936,55044,55044,44303,43159,10741,11885,52549.0,,44133.0,,8416.0,,50504,50504,40253,37103,10251,13401,1504703
233,4952,50376,50376,39421,38487,10955,11889,47773.0,,37113.0,,10660.0,,45557,45557,35532,33905,10025,11652,1504802
234,4979,27831,27831,22120,21182,5711,6649,25824.0,,21787.0,,4037.0,,24199,24199,19030,17740,5169,6459,1504901
235,4995,11388,11388,9382,9067,2006,2321,10525.0,,9215.0,,1310.0,,9957,9957,8686,8390,1271,1567,1505007
236,5010,38364,38364,29945,29155,8419,9209,36094.0,,28103.0,,7991.0,,34663,34663,26593,25016,8070,9647,1505106
237,5037,23622,23622,19402,18515,4220,5107,22007.0,,18839.0,,3168.0,,21001,21001,16767,15625,4234,5376,1505205
238,5053,48950,48950,36935,34304,12015,14646,46340.0,,37032.0,,9308.0,,43627,43627,32117,29214,11510,14413,1505304
239,5070,16609,16609,12906,12505,3703,4104,15721.0,,12731.0,,2990.0,,15185,15185,11653,11099,3532,4086,1505403
240,5096,73912,73912,56673,55686,17239,18226,70282.0,,52655.0,,17627.0,,70774,70774,54397,50788,16377,19986,1505502
241,5118,8930,8930,7203,6790,1727,2140,8467.0,,7316.0,,1151.0,,8184,8184,6747,6261,1437,1923,1505601
242,5134,21762,21762,17462,16677,4300,5085,20308.0,,16875.0,,3433.0,,19684,19684,15842,15060,3842,4624,1505700
243,5150,38829,38829,27133,25378,11696,13451,36739.0,,27634.0,,9105.0,,33569,33569,21758,20115,11811,13454,1505809
244,5177,22784,22784,17377,16156,5407,6628,21345.0,,18063.0,,3282.0,,19363,19363,14368,13097,4995,6266,1505908
245,5193,25762,25762,20302,19725,5460,6037,23781.0,,19507.0,,4274.0,,22510,22510,17217,16390,5293,6120,1506005
246,5215,10972,10972,8405,8028,2567,2944,10416.0,,8627.0,,1789.0,,9982,9982,7871,7437,2111,2545,1506104
247,5231,33939,33939,27649,26802,6290,7137,31516.0,,26598.0,,4918.0,,29542,29542,25534,24255,4008,5287,1506203
248,5258,19837,19837,15613,15045,4224,4792,18764.0,,15428.0,,3336.0,,17495,17495,13984,12886,3511,4609,1506302
249,5274,7098,7098,4693,4366,2405,2732,6740.0,,5454.0,,1286.0,,6431,6431,4004,3695,2427,2736,1506401
250,5290,48901,48901,39131,38911,9770,9990,46590.0,,38376.0,,8214.0,,44061,44061,35959,34915,8102,9146,1506500
251,5312,20689,20689,17353,17306,3336,3383,19553.0,,16969.0,,2584.0,,18667,18667,16332,16257,2335,2410,1506609
252,5339,25021,25021,17066,16957,7955,8064,24532.0,,18646.0,,5886.0,,22172,22172,15167,13919,7005,8253,1506708
253,5355,237660,237660,191329,189098,46331,48562,221537.0,221537.0,174472.0,164204.0,47065.0,57333.0,218296,218296,179880,174019,38416,44277,1506807
254,5371,6309,6309,5286,4918,1023,1391,6038.0,,5382.0,,656.0,,5853,5853,5177,4695,676,1158,1506906
255,5398,25480,25480,20238,19690,5242,5790,24804.0,,20561.0,,4243.0,,22610,22610,18148,17466,4462,5144,1507003
256,5410,16122,16122,12386,11551,3736,4571,15500.0,,12593.0,,2907.0,,14665,14665,11221,10158,3444,4507,1507102
257,5436,23038,23038,19217,18550,3821,4488,21460.0,,18788.0,,2672.0,,20233,20233,17716,16897,2517,3336,1507201
258,5452,42870,42870,30182,29937,12688,12933,41201.0,,31032.0,,10169.0,,36370,36370,25150,23702,11220,12668,1507300
259,5479,15342,15342,12588,12475,2754,2867,14719.0,,12617.0,,2102.0,,13732,13732,11381,11024,2351,2708,1507409
260,5495,11473,11473,8724,8447,2749,3026,10994.0,,9030.0,,1964.0,,11056,11056,7959,7380,3097,3676,1507508
261,5517,41751,41751,33127,32378,8624,9373,39792.0,,32471.0,,7321.0,,37683,37683,29416,27893,8267,9790,1507607
262,5533,22418,22418,17828,16750,4590,5668,20850.0,,17617.0,,3233.0,,19672,19672,15249,14073,4423,5599,1507706
263,5550,12685,12685,9590,9213,3095,3472,11543.0,,9432.0,,2111.0,,9762,9762,8093,7552,1669,2210,1507805
264,5576,22127,22127,17084,15968,5043,6159,20865.0,,16902.0,,3963.0,,19980,19980,15376,13875,4604,6105,1507904
265,5592,52265,52265,39569,38808,12696,13457,49807.0,,39859.0,,9948.0,,47000,47000,35234,33636,11766,13364,1508001
266,5614,75502,75502,55499,54199,20003,21303,75696.0,,58313.0,,17383.0,,75205,75205,55823,52366,19382,22839,1508100
267,5630,40447,40447,30678,29501,9769,10946,38612.0,,29991.0,,8621.0,,36798,36798,28073,26297,8725,10501,1508209
268,5657,45927,45927,33390,32312,12537,13615,43430.0,,34200.0,,9230.0,,40765,40765,29822,28174,10943,12591,1508308
269,5673,65286,65286,47915,48387,17371,16899,63302.0,,47308.0,,15994.0,,58850,58850,43111,40621,15739,18229,1506138
270,5690,14445,14445,10726,10645,3719,3800,14132.0,,11075.0,,3057.0,,13899,13899,10266,9698,3633,4201,1506161
271,5711,37271,37271,26915,26955,10356,10316,36600.0,,27515.0,,9085.0,,33711,33711,24611,23419,9100,10292,1508407
272,5738,30500,30500,21017,20817,9483,9683,29722.0,,21256.0,,8466.0,,29617,29617,20103,19140,9514,10477,1506187
273,5754,29948,29948,22486,22798,7462,7150,29443.0,,22673.0,,6770.0,,28564,28564,20446,19944,8118,8620,1508159
274,5770,19943,19943,15429,15441,4514,4502,19092.0,,15542.0,,3550.0,,17622,17622,13144,12691,4478,4931,1504455
275,5797,21411,21411,15140,14684,6271,6727,20744.0,,15469.0,,5275.0,,20547,20547,14027,12975,6520,7572,1507458
276,5819,23915,23915,19192,18650,4723,5265,22809.0,,18933.0,,3876.0,,21291,21291,16879,15982,4412,5309,1502756
277,5835,182543,182543,142943,143124,39600,39419,162619.0,,128141.0,,34478.0,,156301,156301,116992,114952,39309,41349,1505536
278,5851,17489,17489,12708,12637,4781,4852,17062.0,,13546.0,,3516.0,,16180,16180,11714,11441,4466,4739,1502772
279,5878,22763,22763,17262,16810,5501,5953,21707.0,,17634.0,,4073.0,,21107,21107,15752,14959,5355,6148,1503077
280,5894,19498,19498,14276,14284,5222,5214,18512.0,,14335.0,,4177.0,,17655,17655,12558,12063,5097,5592,1506195
281,5916,28950,28950,21302,20630,7648,8320,27939.0,,21606.0,,6333.0,,26774,26774,18678,17071,8096,9703,1505486
282,5932,6333,6333,5263,5048,1070,1285,5958.0,,5363.0,,595.0,,5308,5308,4722,4591,586,717,1501758
283,5959,25011,25011,17096,16893,7915,8118,24437.0,,17828.0,,6609.0,,22423,22423,14896,14173,7527,8250,1505437
284,5975,30626,30626,23083,23080,7543,7546,29660.0,,23808.0,,5852.0,,30549,30549,21453,20331,9096,10218,1502939
285,5991,12509,12509,9365,9086,3144,3423,12664.0,,10560.0,,2104.0,,11265,11265,9105,8474,2160,2791,1506583
286,6009,3740,3740,3095,2383,645,1357,3544.0,,3106.0,,438.0,,3290,3290,2733,2301,557,989,1600550
287,6017,6880,6880,5495,4560,1385,2320,6497.0,,5299.0,,1198.0,,6081,6081,4905,4254,1176,1827,1600105
288,6025,14210,14210,10624,9476,3586,4734,13681.0,,10240.0,,3441.0,,13504,13504,10644,9541,2860,3963,1600535
289,6033,8294,8294,6279,5298,2015,2996,7615.0,,5990.0,,1625.0,,7590,7590,5806,5121,1784,2469,1600204
290,6041,7359,7359,6008,4504,1351,2855,7365.0,,6271.0,,1094.0,,5644,5644,4764,3985,880,1659,1600253
291,6050,311547,311547,253799,234832,57748,76715,292718.0,292718.0,217162.0,193767.0,75556.0,98951.0,293167,293167,248526,235015,44641,58152,1600303
292,6068,5054,5054,4157,3154,897,1900,4808.0,,4140.0,,668.0,,4254,4254,3547,2892,707,1362,1600212
293,6076,19191,19191,16448,13705,2743,5486,16178.0,,13662.0,,2516.0,,15092,15092,13188,11548,1904,3544,1600402
294,6084,10163,10163,7632,6616,2531,3547,9546.0,,7546.0,,2000.0,,8877,8877,6725,5945,2152,2932,1600154
295,6092,21266,21266,14540,12876,6726,8390,19547.0,,12067.0,,7480.0,,19298,19298,13137,11642,6161,7656,1600501
296,6106,3883,3883,3049,2627,834,1256,3778.0,,3057.0,,721.0,,3596,3596,2902,2597,694,999,1600055
297,6114,6119,6119,5068,4131,1051,1988,5478.0,,4933.0,,545.0,,6740,6740,5105,4076,1635,2664,1600238
298,6122,10197,10197,7810,6647,2387,3550,9916.0,,7816.0,,2100.0,,9728,9728,7763,6676,1965,3052,1600808
299,6130,28982,28982,21344,19025,7638,9957,28372.0,,20668.0,,7704.0,,28762,28762,22422,20079,6340,8683,1600279
300,6157,83411,83411,69745,64696,13666,18715,78332.0,,61999.0,,16333.0,,77459,77459,67121,63090,10338,14369,1600600
301,6173,10391,10391,8197,6658,2194,3733,9727.0,,8021.0,,1706.0,,9028,9028,7349,6177,1679,2851,1600709
302,7005,12201,12201,8337,8175,3864,4026,11886.0,,9143.0,,2743.0,,11208,11208,7850,7594,3358,3614,2100154
303,7013,7139,7139,5438,5267,1701,1872,6805.0,,5686.0,,1119.0,,6177,6177,4807,4519,1370,1658,2100105
304,7021,19349,19349,13799,13817,5550,5532,18561.0,,14312.0,,4249.0,,17472,17472,12537,12549,4935,4923,2100436
305,7030,18188,18188,13358,12462,4830,5726,17722.0,,13672.0,,4050.0,,17688,17688,12659,11068,5029,6620,2100204
306,7048,22854,22854,15750,15424,7104,7430,21949.0,,15913.0,,6036.0,,20816,20816,14284,13819,6532,6997,2100477
307,7056,19442,19442,13685,13697,5757,5745,18722.0,,14444.0,,4278.0,,17538,17538,12359,12165,5179,5373,2100303
308,7064,13711,13711,10344,9685,3367,4026,13124.0,,11144.0,,1980.0,,11972,11972,8965,7882,3007,4090,2100832
309,7072,5734,5734,4031,3925,1703,1809,5561.0,,4574.0,,987.0,,5384,5384,3781,3560,1603,1824,2100402
310,7080,5883,5883,4237,4032,1646,1851,5799.0,,4737.0,,1062.0,,5190,5190,3716,3432,1474,1758,2100550
311,7099,8401,8401,6166,6136,2235,2265,8162.0,,6553.0,,1609.0,,8040,8040,5653,5457,2387,2583,2100501
312,7102,8468,8468,5774,5684,2694,2784,8170.0,,6273.0,,1897.0,,7708,7708,5468,5030,2240,2678,2100873
313,7110,27464,27464,20490,20492,6974,6972,25968.0,,20847.0,,5121.0,,25497,25497,18892,18306,6605,7191,2100600
314,7129,14219,14219,11925,11647,2294,2572,13552.0,,12001.0,,1551.0,,12601,12601,11229,10785,1372,1816,2101251
315,7137,18653,18653,14832,14620,3821,4033,17577.0,,15395.0,,2182.0,,16029,16029,13688,13050,2341,2979,2100709
316,7145,5348,5348,3912,3628,1436,1720,5153.0,,4342.0,,811.0,,4985,4985,3736,3149,1249,1836,2101350
317,7153,14254,14254,11289,11068,2965,3186,13895.0,,12110.0,,1785.0,,12479,12479,10172,9864,2307,2615,2100808
318,7161,7015,7015,5978,5727,1037,1288,6452.0,,5927.0,,525.0,,5913,5913,5104,4794,809,1119,2101731
319,7170,34888,34888,24822,24524,10066,10364,33562.0,,25272.0,,8290.0,,32866,32866,23192,22930,9674,9936,2100907
320,7188,10338,10338,7462,7330,2876,3008,9892.0,,7689.0,,2203.0,,9304,9304,6774,6507,2530,2797,2101772
321,7196,24794,24794,18124,17814,6670,6980,23655.0,,17950.0,,5705.0,,23012,23012,17265,16472,5747,6540,2101004
322,7200,5295,5295,4063,4018,1232,1277,5234.0,,4262.0,,972.0,,5142,5142,3837,3612,1305,1530,2101939
323,7218,9736,9736,8346,8028,1390,1708,9019.0,,8297.0,,722.0,,7968,7968,7147,6750,821,1218,2101103
324,7226,9133,9133,6527,6080,2606,3053,8620.0,,6879.0,,1741.0,,7762,7762,5426,4975,2336,2787,2102374
325,7234,66354,66354,53847,53367,12507,12987,61894.0,,51225.0,,10669.0,,58494,58494,48879,50243,9615,8251,2101202
326,7242,12288,12288,9050,8898,3238,3390,12185.0,,9436.0,,2749.0,,11485,11485,8487,8172,2998,3313,2103752
327,7250,14377,14377,10309,9752,4068,4625,13977.0,,11087.0,,2890.0,,13595,13595,9392,8532,4203,5063,2101301
328,7269,21320,21320,15261,14916,6059,6404,21191.0,,16925.0,,4266.0,,19206,19206,14123,13459,5083,5747,2102036
329,7277,64426,64426,50600,51524,13826,12902,59203.0,,47017.0,,12186.0,,57270,57270,45315,44802,11955,12468,2101400
330,7285,11062,11062,8842,8674,2220,2388,10105.0,,8758.0,,1347.0,,8646,8646,6992,6895,1654,1751,2102077
331,7293,15040,15040,11410,11577,3630,3463,14386.0,,11783.0,,2603.0,,14089,14089,10633,10647,3456,3442,2101509
332,7307,7808,7808,5571,5584,2237,2224,7621.0,,6289.0,,1332.0,,7055,7055,5203,5055,1852,2000,2102150
333,7315,60533,60533,46900,46297,13633,14236,56807.0,,45290.0,,11517.0,,55959,55959,43172,42064,12787,13895,2101608
334,7323,6501,6501,4772,4493,1729,2008,6151.0,,5040.0,,1111.0,,5435,5435,4149,3898,1286,1537,2101970
335,7331,45854,45854,38050,37076,7804,8778,40911.0,,35954.0,,4957.0,,37470,37470,33189,31986,4281,5484,2101707
336,7340,41253,41253,32309,31791,8944,9462,38075.0,,30938.0,,7137.0,,35607,35607,30900,29798,4707,5809,2102325
337,7358,4157,4157,3221,3250,936,907,4049.0,,3596.0,,453.0,,3907,3907,3146,2983,761,924,2101806
338,7366,11870,11870,8930,8856,2940,3014,11711.0,,9689.0,,2022.0,,11016,11016,8224,7865,2792,3151,2102358
339,7374,19272,19272,14217,13692,5055,5580,18708.0,,15260.0,,3448.0,,17448,17448,12925,11131,4523,6317,2101905
340,7382,10322,10322,7467,7421,2855,2901,10090.0,,7850.0,,2240.0,,9640,9640,6948,6780,2692,2860,2102556
341,7390,24350,24350,19287,18751,5063,5599,22581.0,,19603.0,,2978.0,,20505,20505,17109,16531,3396,3974,2102101
342,7404,9162,9162,6915,6917,2247,2245,9092.0,,7563.0,,1529.0,,8715,8715,6571,6377,2144,2338,2102754
343,7412,23066,23066,16752,15746,6314,7320,21759.0,,17066.0,,4693.0,,20914,20914,15041,14714,5873,6200,2102200
344,7420,8036,8036,5509,5272,2527,2764,7740.0,,6038.0,,1702.0,,6995,6995,4586,4128,2409,2867,2103125
345,7439,18870,18870,13085,13219,5785,5651,18366.0,,13722.0,,4644.0,,17900,17900,12373,12285,5527,5615,2102309
346,7447,7702,7702,5828,5685,1874,2017,7402.0,,5970.0,,1432.0,,6839,6839,5431,5039,1408,1800,2103158
347,7455,9738,9738,7207,6565,2531,3173,9491.0,,8016.0,,1475.0,,9084,9084,6429,5582,2655,3502,2102408
348,7463,12458,12458,9277,9114,3181,3344,11732.0,,9494.0,,2238.0,,10896,10896,8165,7922,2731,2974,2103174
349,7471,15652,15652,12063,11539,3589,4113,15167.0,,13043.0,,2124.0,,13949,13949,10757,10001,3192,3948,2102507
350,7480,11591,11591,8523,8318,3068,3273,11287.0,,8858.0,,2429.0,,10718,10718,7948,7647,2770,3071,2103257
351,7498,16522,16522,11877,10966,4645,5556,15936.0,,12625.0,,3311.0,,15335,15335,10904,9778,4431,5557,2102606
352,7501,11984,11984,8882,8653,3102,3331,11561.0,,9395.0,,2166.0,,10602,10602,7913,7599,2689,3003,2103554
353,7510,14272,14272,10144,9946,4128,4326,13998.0,,11055.0,,2943.0,,13030,13030,9303,8887,3727,4143,2102705
354,7528,6222,6222,5027,5003,1195,1219,6059.0,,5456.0,,603.0,,5672,5672,4636,4559,1036,1113,2104073
355,7536,18875,18875,13929,13955,4946,4920,18642.0,,14732.0,,3910.0,,17509,17509,12618,12143,4891,5366,2102804
356,7544,8952,8952,7383,7224,1569,1728,8861.0,,8165.0,,696.0,,7454,7454,6255,5918,1199,1536,2104081
357,7552,19099,19099,14168,13494,4931,5605,18097.0,,14284.0,,3813.0,,17358,17358,12935,11704,4423,5654,2102903
358,7560,12754,12754,10488,10491,2266,2263,11901.0,,10754.0,,1147.0,,11160,11160,9647,9415,1513,1745,2104099
359,7579,108413,108413,86953,86907,21460,21506,101000.0,,84362.0,,16638.0,,96420,96420,80166,80208,16254,16212,2103000
360,7595,9477,9477,6837,6500,2640,2977,9111.0,,7311.0,,1800.0,,8708,8708,6006,5374,2702,3334,2103109
361,7609,14956,14956,11459,11404,3497,3552,14697.0,,12080.0,,2617.0,,13891,13891,10736,10154,3155,3737,2104552
362,7617,54834,54834,44522,44233,10312,10601,49980.0,,42576.0,,7404.0,,46865,46865,40104,39910,6761,6955,2103208
363,7625,6606,6606,4749,4844,1857,1762,6275.0,,4974.0,,1301.0,,6085,6085,4247,4096,1838,1989,2104628
364,7633,78601,78601,58337,58179,20264,20422,72921.0,,56882.0,,16039.0,,70422,70422,53612,53192,16810,17230,2103307
365,7641,8246,8246,5769,5620,2477,2626,8010.0,,6115.0,,1895.0,,7790,7790,5429,5069,2361,2721,2104651
366,7650,32159,32159,24788,24816,7371,7343,29901.0,,24878.0,,5023.0,,28603,28603,24103,24287,4500,4316,2103406
367,7668,18174,18174,12926,12671,5248,5503,17641.0,,14026.0,,3615.0,,16970,16970,12281,11631,4689,5339,2104677
368,7676,27218,27218,21425,21569,5793,5649,24945.0,,21111.0,,3834.0,,23395,23395,19507,19365,3888,4030,2103505
369,7684,12208,12208,8537,8294,3671,3914,11805.0,,9108.0,,2697.0,,11438,11438,8318,7852,3120,3586,2105153
370,7692,44819,44819,33146,33818,11673,11001,42304.0,,34109.0,,8195.0,,40772,40772,32255,31910,8517,8862,2103604
371,7706,9900,9900,7845,7642,2055,2258,9022.0,,8083.0,,939.0,,8090,8090,6868,6612,1222,1478,2105351
372,7714,27642,27642,19799,18876,7843,8766,26675.0,,19975.0,,6700.0,,25217,25217,16753,15388,8464,9829,2103703
373,7722,18470,18470,13815,13519,4655,4951,18578.0,,14784.0,,3794.0,,17191,17191,12647,11991,4544,5200,2105427
374,7730,18553,18553,13995,13829,4558,4724,18040.0,,14466.0,,3574.0,,18142,18142,13379,12749,4763,5393,2103802
375,7749,7175,7175,5210,5094,1965,2081,7022.0,,5784.0,,1238.0,,6562,6562,4825,4636,1737,1926,2105450
376,7757,10107,10107,7418,7209,2689,2898,9717.0,,7647.0,,2070.0,,9349,9349,6895,6712,2454,2637,2103901
377,7765,12544,12544,9967,9815,2577,2729,11999.0,,10770.0,,1229.0,,10949,10949,8740,8506,2209,2443,2105476
378,7773,14206,14206,11090,11033,3116,3173,13415.0,,11336.0,,2079.0,,12849,12849,10353,10255,2496,2594,2104008
379,7781,5071,5071,3704,3633,1367,1438,4978.0,,4335.0,,643.0,,4635,4635,3776,3652,859,983,2105658
380,7790,10120,10120,8152,8177,1968,1943,9577.0,,8429.0,,1148.0,,9026,9026,7517,7288,1509,1738,2104107
381,7803,8509,8509,6566,6457,1943,2052,8328.0,,6741.0,,1587.0,,8033,8033,6249,5980,1784,2053,2105948
382,7811,13111,13111,9484,9429,3627,3682,12554.0,,9780.0,,2774.0,,12203,12203,8685,8618,3518,3585,2104206
383,7820,8807,8807,6125,6254,2682,2553,8645.0,,6726.0,,1919.0,,8354,8354,6063,5959,2291,2395,2105922
384,7838,8903,8903,6326,5833,2577,3070,8608.0,,6858.0,,1750.0,,7869,7869,5319,4681,2550,3188,2104305
385,7846,9704,9704,7305,7397,2399,2307,9363.0,,7761.0,,1602.0,,8833,8833,6592,6554,2241,2279,2105963
386,7854,13812,13812,9646,9771,4166,4041,13441.0,,10715.0,,2726.0,,12854,12854,9036,8907,3818,3947,2104404
387,7862,5990,5990,4957,4897,1033,1093,5700.0,,5167.0,,533.0,,5339,5339,4671,4411,668,928,2105989
388,7870,8696,8696,6193,6193,2503,2503,8591.0,,6872.0,,1719.0,,8297,8297,5920,5675,2377,2622,2104503
389,7889,14747,14747,10954,10699,3793,4048,13716.0,,11700.0,,2016.0,,12717,12717,10103,9673,2614,3044,2106326
390,7897,11845,11845,8378,8463,3467,3382,11524.0,,8892.0,,2632.0,,11520,11520,8050,7914,3470,3606,2104602
391,7900,6439,6439,4689,4521,1750,1918,6531.0,,5306.0,,1225.0,,6416,6416,4629,4409,1787,2007,2106359
392,7919,6405,6405,4814,4650,1591,1755,6111.0,,5080.0,,1031.0,,5734,5734,4234,3976,1500,1758,2104701
393,7927,8221,8221,6120,5914,2101,2307,7878.0,,6298.0,,1580.0,,7475,7475,5695,5413,1780,2062,2106375
394,7935,47448,47448,38444,37986,9004,9462,42766.0,,36081.0,,6685.0,,39100,39100,33940,32747,5160,6353,2104800
395,7943,6373,6373,5054,4977,1319,1396,6150.0,,5465.0,,685.0,,5478,5478,4825,4678,653,800,2106631
396,7951,9625,9625,7229,6984,2396,2641,9185.0,,7504.0,,1681.0,,8864,8864,6840,6352,2024,2512,2104909
397,7960,6167,6167,4641,4360,1526,1807,5964.0,,5043.0,,921.0,,5742,5742,4160,3893,1582,1849,2106672
398,7978,23822,23822,17651,15950,6171,7872,22581.0,,18133.0,,4448.0,,21541,21541,15374,12961,6167,8580,2105005
399,7986,4443,4443,3555,3516,888,927,4291.0,,3745.0,,546.0,,4181,4181,3382,3247,799,934,2107258
400,7994,20942,20942,17667,15637,3275,5305,19438.0,,17654.0,,1784.0,,17155,17155,15213,13087,1942,4068,2105104
401,8001,13604,13604,9857,9384,3747,4220,13281.0,,10261.0,,3020.0,,12882,12882,9404,8720,3478,4162,2107357
402,8010,8091,8091,6822,6683,1269,1408,7657.0,,6704.0,,953.0,,7179,7179,6359,6125,820,1054,2105203
403,8028,11463,11463,7859,7570,3604,3893,11233.0,,8871.0,,2362.0,,10166,10166,6945,6544,3221,3622,2107456
404,8036,182605,182605,147426,148317,35179,34288,169217.0,,137703.0,,31514.0,,162477,162477,137235,136275,25242,26202,2105302
405,8044,15316,15316,11332,10939,3984,4377,14449.0,,11744.0,,2705.0,,13285,13285,9737,9238,3548,4047,2108058
406,8052,17225,17225,12866,13238,4359,3987,16460.0,,13804.0,,2656.0,,15742,15742,12550,12744,3192,2998,2111409
407,8060,18881,18881,13148,12724,5733,6157,18405.0,,14448.0,,3957.0,,16901,16901,12157,11316,4744,5585,2108256
408,8079,45174,45174,35145,34436,10029,10738,42583.0,,35333.0,,7250.0,,39957,39957,33482,32750,6475,7207,2105401
409,8087,15900,15900,12537,12404,3363,3496,15155.0,,13024.0,,2131.0,,14034,14034,11823,11520,2211,2514,2108454
410,8095,20449,20449,16792,16714,3657,3735,18848.0,,16307.0,,2541.0,,16784,16784,14413,14101,2371,2683,2105500
411,8109,7114,7114,4984,4385,2130,2729,6972.0,,5925.0,,1047.0,,6496,6496,4326,3464,2170,3032,2109056
412,8117,11792,11792,9402,9357,2390,2435,10682.0,,9389.0,,1293.0,,9546,9546,8019,7878,1527,1668,2105609
413,8125,5433,5433,4085,3999,1348,1434,5215.0,,4111.0,,1104.0,,5245,5245,3791,3558,1454,1687,2109239
414,8133,32906,32906,26256,26186,6650,6720,31090.0,,26636.0,,4454.0,,28342,28342,24491,23562,3851,4780,2105708
415,8141,16045,16045,10797,10585,5248,5460,15377.0,,11669.0,,3708.0,,14223,14223,10190,9749,4033,4474,2109270
416,8150,8588,8588,6451,6373,2137,2215,8446.0,,6742.0,,1704.0,,8357,8357,6291,6293,2066,2064,2105807
417,8168,20532,20532,17050,16604,3482,3928,19095.0,,16403.0,,2692.0,,18090,18090,15236,14299,2854,3791,2109452
418,8176,13089,13089,9310,9232,3779,3857,13033.0,,10318.0,,2715.0,,12140,12140,8490,8492,3650,3648,2105906
419,8184,6775,6775,5069,4987,1706,1788,6771.0,,5537.0,,1234.0,,6377,6377,4780,4542,1597,1835,2109551
420,8192,11030,11030,8400,8381,2630,2649,10569.0,,8545.0,,2024.0,,9905,9905,7419,7163,2486,2742,2106003
421,8206,5701,5701,4703,4639,998,1062,5424.0,,4945.0,,479.0,,4720,4720,4184,4006,536,714,2109759
422,8214,8722,8722,6590,6508,2132,2214,8512.0,,7073.0,,1439.0,,8400,8400,6109,5967,2291,2433,2106102
423,8222,8712,8712,5965,5711,2747,3001,8523.0,,6572.0,,1951.0,,8291,8291,5680,5270,2611,3021,2110237
424,8230,6074,6074,4480,4265,1594,1809,5863.0,,4720.0,,1143.0,,5717,5717,4159,3675,1558,2042,2106201
425,8249,11496,11496,9072,8089,2424,3407,10921.0,,9642.0,,1279.0,,9665,9665,7594,6261,2071,3404,2110278
426,8257,13667,13667,9589,9462,4078,4205,13247.0,,10143.0,,3104.0,,12718,12718,8723,8341,3995,4377,2106300
427,8265,6322,6322,5203,5096,1119,1226,6010.0,,5520.0,,490.0,,5525,5525,4522,4353,1003,1172,2110658
428,8273,14674,14674,12288,11914,2386,2760,13485.0,,12206.0,,1279.0,,12682,12682,11212,10759,1470,1923,2106409
429,8281,8045,8045,6176,6046,1869,1999,7912.0,,6789.0,,1123.0,,7027,7027,5396,5042,1631,1985,2110856
430,8290,18964,18964,15344,14782,3620,4182,18065.0,,15871.0,,2194.0,,16952,16952,13950,13140,3002,3812,2106508
431,8303,11055,11055,7353,7195,3702,3860,10768.0,,8147.0,,2621.0,,10015,10015,6848,6503,3167,3512,2111029
432,8311,25490,25490,19334,18924,6156,6566,24285.0,,20231.0,,4054.0,,22383,22383,17434,17265,4949,5118,2106607
433,8320,8760,8760,6727,6690,2033,2070,8578.0,,7191.0,,1387.0,,8186,8186,6244,6049,1942,2137,2111052
434,8338,15259,15259,12332,12239,2927,3020,14274.0,,12409.0,,1865.0,,13584,13584,11056,10883,2528,2701,2106706
435,8346,13562,13562,10531,10459,3031,3103,12770.0,,10985.0,,1785.0,,11286,11286,9311,9053,1975,2233,2111078
436,8354,11094,11094,8718,8454,2376,2640,10324.0,,8779.0,,1545.0,,9653,9653,7934,7442,1719,2211,2106805
437,8362,6275,6275,4981,4923,1294,1352,5975.0,,5278.0,,697.0,,5171,5171,4381,4293,790,878,2111250
438,8370,19806,19806,14856,14496,4950,5310,18599.0,,15422.0,,3177.0,,18204,18204,14770,14219,3434,3985,2106904
439,8389,9988,9988,7091,6860,2897,3128,9494.0,,7284.0,,2210.0,,9314,9314,6487,6070,2827,3244,2111532
440,8397,7254,7254,5989,5932,1265,1322,6733.0,,5948.0,,785.0,,6096,6096,5347,5143,749,953,2107001
441,8400,4506,4506,3646,3566,860,940,4360.0,,3662.0,,698.0,,3890,3890,3040,2902,850,988,2111573
442,8419,16649,16649,12753,11976,3896,4673,15855.0,,13089.0,,2766.0,,14847,14847,11354,10197,3493,4650,2107100
443,8427,5579,5579,3961,3908,1618,1671,5480.0,,4481.0,,999.0,,5292,5292,3853,3593,1439,1699,2111631
444,8435,10103,10103,7712,7201,2391,2902,9508.0,,7729.0,,1779.0,,8925,8925,6641,6077,2284,2848,2107209
445,8443,4797,4797,3584,3551,1213,1246,4712.0,,3971.0,,741.0,,4542,4542,3432,3272,1110,1270,2111672
446,8451,3959,3959,3092,2989,867,970,3856.0,,3443.0,,413.0,,3689,3689,2963,2776,726,913,2107308
447,8460,7219,7219,5467,5353,1752,1866,6801.0,,5649.0,,1152.0,,5760,5760,4272,4072,1488,1688,2111722
448,8478,15714,15714,11186,11131,4528,4583,15216.0,,11685.0,,3531.0,,14993,14993,10427,10101,4566,4892,2107407
449,8486,8618,8618,6085,6076,2533,2542,8382.0,,6756.0,,1626.0,,7602,7602,5441,5296,2161,2306,2111748
450,8494,74725,74725,64090,62546,10635,12179,68535.0,,58019.0,,10516.0,,62922,62922,54056,51963,8866,10959,2107506
451,8508,13002,13002,9415,9431,3587,3571,12663.0,,9890.0,,2773.0,,12149,12149,8743,8544,3406,3605,2111763
452,8516,17314,17314,12179,11723,5135,5591,16769.0,,13274.0,,3495.0,,16216,16216,11162,10459,5054,5757,2107605
453,8524,8988,8988,6757,6289,2231,2699,8545.0,,6951.0,,1594.0,,8281,8281,5705,5297,2576,2984,2111789
454,8532,14531,14531,10960,11065,3571,3466,13886.0,,11222.0,,2664.0,,13295,13295,9929,10135,3366,3160,2107704
455,8540,4619,4619,3448,3503,1171,1116,4535.0,,3863.0,,672.0,,4285,4285,2929,2956,1356,1329,2111953
456,8559,27597,27597,18967,18990,8630,8607,26934.0,,20384.0,,6550.0,,26373,26373,17989,17279,8384,9094,2107803
457,8567,16654,16654,13361,13237,3293,3417,15930.0,,13312.0,,2618.0,,15309,15309,11849,11576,3460,3733,2112233
458,8575,13694,13694,10501,10546,3193,3148,12816.0,,10817.0,,1999.0,,12108,12108,9923,9796,2185,2312,2107902
459,8583,5954,5954,4460,4307,1494,1647,5819.0,,4915.0,,904.0,,5635,5635,4369,4086,1266,1549,2112274
460,8591,14630,14630,11352,11403,3278,3227,13846.0,,12084.0,,1762.0,,12994,12994,10093,9881,2901,3113,2108009
461,8605,16646,16646,11081,10753,5565,5893,15728.0,,11880.0,,3848.0,,14784,14784,9781,9170,5003,5614,2112456
462,8613,30962,30962,23061,23001,7901,7961,30005.0,,22898.0,,7107.0,,29627,29627,21273,20742,8354,8885,2108207
463,8621,8634,8634,6408,6140,2226,2494,8316.0,,6874.0,,1442.0,,7507,7507,5566,5049,1941,2458,2112852
464,8630,28237,28237,18960,18175,9277,10062,26493.0,,19624.0,,6869.0,,25895,25895,16782,15841,9113,10054,2108306
465,8656,12061,12061,8661,8094,3400,3967,11864.0,,9332.0,,2532.0,,11460,11460,7896,6799,3564,4661,2108405
466,8672,25556,25556,19474,19040,6082,6516,24345.0,,20050.0,,4295.0,,22697,22697,18545,17811,4152,4886,2108504
467,8699,59841,59841,46195,45168,13646,14673,53854.0,,44464.0,,9390.0,,48380,48380,41807,39782,6573,8598,2108603
468,8710,20378,20378,14596,14332,5782,6046,19842.0,,15333.0,,4509.0,,19951,19951,14194,13834,5757,6117,2108702
469,8737,12568,12568,9391,9244,3177,3324,11913.0,,10013.0,,1900.0,,11262,11262,9207,8673,2055,2589,2108801
470,8753,14639,14639,11455,11258,3184,3381,14410.0,,12362.0,,2048.0,,13577,13577,11012,10724,2565,2853,2108900
471,8770,17576,17576,14139,14030,3437,3546,16605.0,,14306.0,,2299.0,,15545,15545,13358,12689,2187,2856,2109007
472,8796,29754,29754,24147,24295,5607,5459,27378.0,,23171.0,,4207.0,,24875,24875,20897,20365,3978,4510,2109106
473,8818,10631,10631,7542,7180,3089,3451,10260.0,,8118.0,,2142.0,,9385,9385,6934,6226,2451,3159,2109205
474,8834,10500,10500,7823,7353,2677,3147,10132.0,,8374.0,,1758.0,,9546,9546,7189,6641,2357,2905,2109304
475,8850,11220,11220,8309,7204,2911,4016,10717.0,,8871.0,,1846.0,,10167,10167,7406,5849,2761,4318,2109403
476,8877,16168,16168,12516,12684,3652,3484,15293.0,,12854.0,,2439.0,,14402,14402,11329,11144,3073,3258,2109502
477,8893,115164,115164,95159,93054,20005,22110,105328.0,,84890.0,,20438.0,,100253,100253,83895,80682,16358,19571,2111201
478,8915,30265,30265,24803,24158,5462,6107,27919.0,,23680.0,,4239.0,,26149,26149,22982,22203,3167,3946,2109601
479,8931,5692,5692,4410,4116,1282,1576,5569.0,,5010.0,,559.0,,5184,5184,4047,3443,1137,1741,2109700
480,8958,23160,23160,17150,16925,6010,6235,21758.0,,18328.0,,3430.0,,19760,19760,16207,15348,3553,4412,2109809
481,8974,43022,43022,33692,33242,9330,9780,40690.0,,33693.0,,6997.0,,38445,38445,33397,32786,5048,5659,2110005
482,8990,22337,22337,15854,15822,6483,6515,21632.0,,17115.0,,4517.0,,20875,20875,14871,14368,6004,6507,2110104
483,9016,24640,24640,19281,18913,5359,5727,23036.0,,18500.0,,4536.0,,21784,21784,17960,17417,3824,4367,2110203
484,9032,14946,14946,11728,11631,3218,3315,14432.0,,12374.0,,2058.0,,13707,13707,10608,10190,3099,3517,2110302
485,9059,14436,14436,11986,11489,2450,2947,13344.0,,11999.0,,1345.0,,12530,12530,11187,10476,1343,2054,2110401
486,9075,28576,28576,20981,20322,7595,8254,27237.0,,22367.0,,4870.0,,25880,25880,19502,18223,6378,7657,2110500
487,9091,23134,23134,16744,16468,6390,6666,21923.0,,17026.0,,4897.0,,20981,20981,15102,14630,5879,6351,2110609
488,9113,29399,29399,21710,22108,7689,7291,27905.0,,22015.0,,5890.0,,27657,27657,19921,19564,7736,8093,2110708
489,9130,4216,4216,3069,2979,1147,1237,4191.0,,3579.0,,612.0,,3932,3932,2970,2656,962,1276,2110807
490,9156,9910,9910,7156,7289,2754,2621,9695.0,,7566.0,,2129.0,,9441,9441,6718,6714,2723,2727,2110906
491,9172,19677,19677,14769,13489,4908,6188,19000.0,,15949.0,,3051.0,,18773,18773,14086,11809,4687,6964,2111003
492,9199,20808,20808,15271,15310,5537,5498,20259.0,,15520.0,,4739.0,,19958,19958,13878,13592,6080,6366,2111102
493,9210,749873,749873,630275,619844,119598,130029,699954.0,699954.0,553499.0,519050.0,146455.0,180904.0,692497,692497,587683,568386,104814,124111,2111300
494,9237,27687,27687,21265,21404,6422,6283,25385.0,,20609.0,,4776.0,,22842,22842,19008,19116,3834,3726,2111508
495,9253,16095,16095,11948,11602,4147,4493,15451.0,,12763.0,,2688.0,,14837,14837,10712,10270,4125,4567,2111607
496,9270,16474,16474,11775,11236,4699,5238,15975.0,,12708.0,,3267.0,,15451,15451,10728,9945,4723,5506,2111706
497,9296,13401,13401,11419,11391,1982,2010,12618.0,,11491.0,,1127.0,,11992,11992,11013,10699,979,1293,2111805
498,9318,8823,8823,6751,6694,2072,2129,8682.0,,7234.0,,1448.0,,8432,8432,6140,6058,2292,2374,2111904
499,9334,7110,7110,5537,5468,1573,1642,6956.0,,5970.0,,986.0,,6532,6532,4941,4640,1591,1892,2112001
500,9350,20553,20553,14848,15161,5705,5392,19372.0,,15540.0,,3832.0,,18658,18658,13733,13904,4925,4754,2112100
501,9377,115629,115629,97017,96713,18612,18916,107907.0,,91280.0,,16627.0,,104287,104287,89145,88204,15142,16083,2112209
502,9393,27039,27039,21555,21192,5484,5847,25332.0,,21903.0,,3429.0,,23062,23062,19644,18780,3418,4282,2112308
503,9415,29128,29128,21332,19225,7796,9903,27710.0,,22057.0,,5653.0,,27060,27060,19252,17205,7808,9855,2112407
504,9431,39046,39046,30531,29819,8515,9227,35054.0,,29665.0,,5389.0,,31183,31183,26603,26428,4580,4755,2112506
505,9458,23904,23904,19337,19003,4567,4901,22019.0,,19359.0,,2660.0,,20291,20291,17180,16735,3111,3556,2112605
506,9474,31175,31175,24160,23876,7015,7299,28656.0,,24159.0,,4497.0,,26739,26739,22352,21936,4387,4803,2112704
507,9490,38545,38545,29804,28792,8741,9753,36403.0,,30545.0,,5858.0,,34491,34491,27849,26126,6642,8365,2112803
508,9512,26802,26802,18411,18105,8391,8697,26223.0,,19824.0,,6399.0,,25789,25789,17662,17069,8127,8720,2112902
509,9539,25323,25323,18009,18078,7314,7245,24610.0,,18441.0,,6169.0,,24513,24513,17448,17070,7065,7443,2113009
510,9555,28937,28937,20051,19651,8886,9286,27571.0,,20040.0,,7531.0,,27100,27100,18803,18039,8297,9061,2102002
511,9571,58946,58946,47156,46716,11790,12230,54971.0,,44939.0,,10032.0,,53059,53059,44207,42945,8852,10114,2109908
512,9598,16108,16108,12385,12218,3723,3890,15236.0,,12803.0,,2433.0,,14121,14121,11246,10899,2875,3222,2108108
513,9610,75967,75967,60268,60177,15699,15790,71572.0,,57549.0,,14023.0,,70283,70283,56978,55900,13305,14383,2100055
514,9636,22965,22965,17960,17991,5005,4974,21600.0,,17847.0,,3753.0,,20339,20339,16926,16551,3413,3788,2104057
515,9652,17854,17854,13141,12968,4713,4886,17206.0,,13384.0,,3822.0,,16882,16882,12321,11888,4561,4994,2110039
516,9679,22621,22621,16508,16205,6113,6416,21509.0,,16500.0,,5009.0,,21284,21284,15205,14682,6079,6602,2100956
517,9695,17018,17018,12489,12020,4529,4998,16968.0,,13564.0,,3404.0,,15767,15767,11649,10690,4118,5077,2106755
518,9717,31682,31682,24586,24428,7096,7254,29114.0,,23980.0,,5134.0,,27771,27771,23828,23058,3943,4713,2114007
519,10006,7624,7624,5959,5872,1665,1752,7141.0,,5789.0,,1352.0,,6741,6741,5413,5265,1328,1476,2201960
520,10014,5077,5077,4036,3964,1041,1113,4869.0,,4099.0,,770.0,,4709,4709,4076,3800,633,909,2200103
521,10022,4358,4358,3482,3318,876,1040,4244.0,,3736.0,,508.0,,3945,3945,3511,3304,434,641,2200277
522,10030,15314,15314,12712,12294,2602,3020,14549.0,,12738.0,,1811.0,,13651,13651,11985,11315,1666,2336,2200202
523,10049,9670,9670,8432,8378,1238,1292,9000.0,,8502.0,,498.0,,7986,7986,7082,6969,904,1017,2201150
524,10057,12304,12304,10589,10149,1715,2155,11835.0,,10506.0,,1329.0,,11399,11399,9970,9249,1429,2150,2200301
525,10065,6092,6092,5131,4978,961,1114,5980.0,,5373.0,,607.0,,5546,5546,4737,4572,809,974,2201919
526,10073,33709,33709,29175,29076,4534,4633,31604.0,,27472.0,,4132.0,,30394,30394,26693,26418,3701,3976,2200400
527,10081,4986,4986,4107,4024,879,962,4889.0,,4343.0,,546.0,,4666,4666,3810,3613,856,1053,2201929
528,10090,15144,15144,12107,11726,3037,3418,14598.0,,12266.0,,2332.0,,14232,14232,11683,10972,2549,3260,2200509
529,10103,6428,6428,5545,5371,883,1057,6088.0,,5515.0,,573.0,,5800,5800,4971,4705,829,1095,2202026
530,10111,6816,6816,5356,5296,1460,1520,6474.0,,5595.0,,879.0,,6159,6159,5215,4858,944,1301,2200608
531,10120,9223,9223,7279,7051,1944,2172,8884.0,,7483.0,,1401.0,,8556,8556,7105,6757,1451,1799,2202059
532,10138,6924,6924,5764,5741,1160,1183,6524.0,,5750.0,,774.0,,6368,6368,5345,5288,1023,1080,2200707
533,10146,4961,4961,4337,4259,624,702,4706.0,,4217.0,,489.0,,4434,4434,3926,3817,508,617,2202091
534,10154,2951,2951,2394,2320,557,631,2941.0,,2572.0,,369.0,,2776,2776,2174,2071,602,705,2200806
535,10162,3346,3346,2666,2525,680,821,3229.0,,2887.0,,342.0,,2677,2677,2289,2179,388,498,2202251
536,10170,5585,5585,4481,4267,1104,1318,5339.0,,4668.0,,671.0,,5065,5065,4314,3945,751,1120,2200905
537,10189,5042,5042,4501,4290,541,752,4842.0,,4441.0,,401.0,,4470,4470,3974,3745,496,725,2202737
538,10197,4201,4201,3387,3303,814,898,4002.0,,3516.0,,486.0,,3740,3740,3151,2975,589,765,2201002
539,10200,5160,5160,4206,4102,954,1058,4850.0,,4284.0,,566.0,,4440,4440,3800,3686,640,754,2202752
540,10219,9277,9277,7325,7152,1952,2125,8861.0,,7814.0,,1047.0,,8251,8251,6969,6982,1282,1269,2201101
541,10227,6260,6260,4793,4701,1467,1559,6095.0,,5167.0,,928.0,,5849,5849,4730,4586,1119,1263,2202778
542,10235,36417,36417,28620,28250,7797,8167,34744.0,,28791.0,,5953.0,,34109,34109,27675,26897,6434,7212,2201200
543,10243,4726,4726,4125,3994,601,732,4612.0,,4272.0,,340.0,,4407,4407,3837,3671,570,736,2202851
544,10251,3516,3516,2674,2555,842,961,3432.0,,3167.0,,265.0,,2533,2533,2126,2022,407,511,2201309
545,10260,4460,4460,3702,3638,758,822,4245.0,,3836.0,,409.0,,3979,3979,3282,3253,697,726,2203750
546,10278,5899,5899,4577,4511,1322,1388,5813.0,,4904.0,,909.0,,5448,5448,4596,4362,852,1086,2201408
547,10286,4933,4933,4402,4352,531,581,4761.0,,4395.0,,366.0,,4575,4575,4078,3966,497,609,2205151
548,10294,22295,22295,16568,16330,5727,5965,21142.0,,16445.0,,4697.0,,20700,20700,16311,15941,4389,4759,2201507
549,10308,4307,4307,3533,3402,774,905,4191.0,,3775.0,,416.0,,3740,3740,3258,3034,482,706,2205250
550,10316,9293,9293,7736,7597,1557,1696,8988.0,,7741.0,,1247.0,,8631,8631,7474,7327,1157,1304,2201606
551,10324,7871,7871,6694,6483,1177,1388,7508.0,,6636.0,,872.0,,7093,7093,6226,5878,867,1215,2205557
552,10332,4521,4521,3804,3689,717,832,4346.0,,3879.0,,467.0,,4278,4278,3645,3546,633,732,2201705
553,10340,4300,4300,3649,3680,651,620,4009.0,,3592.0,,417.0,,3813,3813,3410,3385,403,428,2205565
554,10359,5221,5221,4581,4400,640,821,5066.0,,4754.0,,312.0,,4675,4675,4254,4059,421,616,2201804
555,10367,7431,7431,6362,6329,1069,1102,6944.0,,6241.0,,703.0,,6658,6658,5841,5804,817,854,2205953
556,10375,18684,18684,15841,15669,2843,3015,17513.0,,15149.0,,2364.0,,16652,16652,14052,13836,2600,2816,2201903
557,10383,5367,5367,4434,4329,933,1038,5249.0,,4730.0,,519.0,,4972,4972,4269,4157,703,815,2207777
558,10391,16471,16471,13636,13505,2835,2966,15701.0,,13646.0,,2055.0,,15099,15099,12959,12741,2140,2358,2202000
559,10405,3867,3867,2965,2843,902,1024,3836.0,,3348.0,,488.0,,3404,3404,2866,2780,538,624,2207751
560,10413,5227,5227,4158,4077,1069,1150,5210.0,,4547.0,,663.0,,4835,4835,3991,3815,844,1020,2202109
561,10421,6782,6782,5910,5928,872,854,6467.0,,5895.0,,572.0,,6141,6141,5528,5464,613,677,2208650
562,10430,34765,34765,29297,29105,5468,5660,33874.0,,28435.0,,5439.0,,33457,33457,28605,28020,4852,5437,2202208
563,10448,3485,3485,2727,2577,758,908,3445.0,,2901.0,,544.0,,3183,3183,2687,2391,496,792,2209153
564,10456,15438,15438,12196,12030,3242,3408,14671.0,,12051.0,,2620.0,,14454,14454,11615,11362,2839,3092,2202307
565,10464,4558,4558,3503,3476,1055,1082,4482.0,,3914.0,,568.0,,4193,4193,3425,3321,768,872,2209377
566,10472,10134,10134,8027,7968,2107,2166,9592.0,,8203.0,,1389.0,,8834,8834,7590,7411,1244,1423,2202406
567,10480,3995,3995,3417,3431,578,564,3863.0,,3548.0,,315.0,,3646,3646,3198,3174,448,472,2209351
568,10499,7985,7985,6561,6545,1424,1440,7493.0,,6712.0,,781.0,,7210,7210,6360,6150,850,1060,2202505
569,10502,3976,3976,3302,3253,674,723,3812.0,,3433.0,,379.0,,3648,3648,3044,2977,604,671,2209559
570,10510,16097,16097,12421,12193,3676,3904,15548.0,,12625.0,,2923.0,,15214,15214,11977,11566,3237,3648,2202604
571,10529,4929,4929,4200,4125,729,804,4735.0,,4144.0,,591.0,,4565,4565,3975,3885,590,680,2210052
572,10537,21130,21130,17399,17479,3731,3651,19815.0,,17291.0,,2524.0,,18541,18541,15789,15895,2752,2646,2202703
573,10545,8530,8530,7319,7016,1211,1514,8079.0,,7227.0,,852.0,,7720,7720,6724,6274,996,1446,2210656
574,10553,4607,4607,3858,3656,749,951,4476.0,,4022.0,,454.0,,4220,4220,3709,3390,511,830,2202802
575,10561,4950,4950,4175,4125,775,825,4805.0,,4444.0,,361.0,,4462,4462,3783,3650,679,812,2210359
576,10570,20304,20304,16056,16107,4248,4197,19306.0,,15985.0,,3321.0,,18854,18854,14937,14883,3917,3971,2202901
577,10588,4554,4554,3762,3711,792,843,4382.0,,3964.0,,418.0,,4129,4129,3437,3281,692,848,2211357
578,10596,5423,5423,4413,4408,1010,1015,5148.0,,4707.0,,441.0,,4719,4719,3952,3894,767,825,2203008
579,10600,3403,3403,2671,2655,732,748,3314.0,,2860.0,,454.0,,3054,3054,2569,2505,485,549,2201176
580,10618,7735,7735,6246,6096,1489,1639,7383.0,,6307.0,,1076.0,,6781,6781,5729,5618,1052,1163,2203107
581,10626,3380,3380,3082,3075,298,305,3311.0,,3171.0,,140.0,,3125,3125,2911,2874,214,251,2201556
582,10634,8756,8756,7095,7075,1661,1681,8311.0,,7284.0,,1027.0,,7786,7786,6441,6279,1345,1507,2203206
583,10642,3748,3748,3118,3107,630,641,3599.0,,3167.0,,432.0,,3405,3405,2787,2824,618,581,2201988
584,10650,12149,12149,10121,10017,2028,2132,11234.0,,9581.0,,1653.0,,10673,10673,9402,9161,1271,1512,2203305
585,10669,6396,6396,5058,4918,1338,1478,6126.0,,5271.0,,855.0,,5707,5707,4784,4463,923,1244,2201770
586,10677,6114,6114,5427,5398,687,716,5966.0,,5601.0,,365.0,,5694,5694,5112,4983,582,711,2203404
587,10685,7088,7088,6113,6019,975,1069,6730.0,,5958.0,,772.0,,6488,6488,5577,5382,911,1106,2203453
588,10693,12733,12733,9868,9553,2865,3180,12327.0,,10045.0,,2282.0,,12259,12259,9866,9224,2393,3035,2203503
589,10707,3643,3643,3114,3094,529,549,3437.0,,3113.0,,324.0,,3278,3278,2930,2871,348,407,2202455
590,10715,3704,3704,2913,2864,791,840,3650.0,,3262.0,,388.0,,3332,3332,2781,2713,551,619,2203602
591,10723,5022,5022,4104,4078,918,944,4850.0,,4449.0,,401.0,,4571,4571,4033,3975,538,596,2202133
592,10731,30568,30568,23907,23794,6661,6774,29308.0,,23938.0,,5370.0,,28221,28221,22795,22478,5426,5743,2203701
593,10740,5252,5252,4258,4110,994,1142,4807.0,,4260.0,,547.0,,4339,4339,3710,3626,629,713,2202174
594,10758,4190,4190,3257,3139,933,1051,4033.0,,3599.0,,434.0,,3708,3708,3070,3016,638,692,2203800
595,10766,5154,5154,4393,4288,761,866,4970.0,,4527.0,,443.0,,4841,4841,4027,3907,814,934,2203230
596,10774,44497,44497,35907,35853,8590,8644,42879.0,,33984.0,,8895.0,,42796,42796,34275,33731,8521,9065,2203909
597,10782,6002,6002,5165,5140,837,862,5863.0,,5372.0,,491.0,,5470,5470,4728,4676,742,794,2204352
598,10790,4360,4360,3381,3279,979,1081,4209.0,,3534.0,,675.0,,3966,3966,3263,2994,703,972,2204006
599,10804,4206,4206,3287,3217,919,989,3941.0,,3622.0,,319.0,,3577,3577,3082,3006,495,571,2204550
600,10812,4500,4500,3602,3457,898,1043,4194.0,,3791.0,,403.0,,3731,3731,3216,3075,515,656,2204105
601,10820,8602,8602,7004,7015,1598,1587,8063.0,,6906.0,,1157.0,,7653,7653,6422,6315,1231,1338,2204659
602,10839,7244,7244,5845,5722,1399,1522,7231.0,,6186.0,,1045.0,,7324,7324,5773,5462,1551,1862,2204204
603,10847,4691,4691,3897,3853,794,838,4497.0,,3896.0,,601.0,,4335,4335,3704,3596,631,739,2205532
604,10855,9414,9414,7740,7408,1674,2006,8906.0,,7840.0,,1066.0,,8680,8680,7561,7110,1119,1570,2204303
605,10863,5797,5797,4578,4577,1219,1220,5495.0,,4764.0,,731.0,,4853,4853,3967,3989,886,864,2205573
606,10871,8094,8094,6492,6347,1602,1747,7467.0,,6487.0,,980.0,,7089,7089,5828,5693,1261,1396,2204402
607,10880,3586,3586,2906,2821,680,765,3332.0,,3008.0,,324.0,,3133,3133,2657,2598,476,535,2206654
608,10898,8598,8598,6414,6384,2184,2214,8331.0,,6891.0,,1440.0,,7876,7876,6365,6147,1511,1729,2204501
609,10901,4372,4372,3731,3512,641,860,4276.0,,3916.0,,360.0,,3943,3943,3369,3002,574,941,2206951
610,10910,4173,4173,3500,3240,673,933,4043.0,,3595.0,,448.0,,3671,3671,3204,2854,467,817,2204600
611,10928,5424,5424,4612,4531,812,893,5100.0,,4423.0,,677.0,,4794,4794,4123,3939,671,855,2206753
612,10936,12726,12726,10032,10039,2694,2687,12385.0,,10441.0,,1944.0,,11949,11949,9360,9348,2589,2601,2204709
613,10944,3855,3855,3414,3311,441,544,3749.0,,3476.0,,273.0,,3371,3371,3134,2991,237,380,2207553
614,10952,7418,7418,6081,6105,1337,1313,7097.0,,6290.0,,807.0,,6704,6704,5809,5748,895,956,2204808
615,10960,3827,3827,3359,3278,468,549,3672.0,,3414.0,,258.0,,3448,3448,3016,2971,432,477,2207959
616,10979,6132,6132,5103,5101,1029,1031,5854.0,,5278.0,,576.0,,5546,5546,4799,4744,747,802,2204907
617,10987,7099,7099,5704,5703,1395,1396,6754.0,,5947.0,,807.0,,6246,6246,5384,5386,862,860,2209971
618,10995,9392,9392,7821,7922,1571,1470,9030.0,,7948.0,,1082.0,,8705,8705,7407,7444,1298,1261,2205003
619,11010,8882,8882,7001,6934,1881,1948,8637.0,,7445.0,,1192.0,,8191,8191,6708,6540,1483,1651,2205102
620,11037,13411,13411,10273,10301,3138,3110,12798.0,,10714.0,,2084.0,,12282,12282,10143,10100,2139,2182,2205201
621,11053,4633,4633,3735,3584,898,1049,4432.0,,3857.0,,575.0,,4043,4043,3497,3260,546,783,2205300
622,11070,11451,11451,9241,9143,2210,2308,10814.0,,9267.0,,1547.0,,10294,10294,8827,8787,1467,1507,2205409
623,11088,4676,4676,3894,3765,782,911,4525.0,,4078.0,,447.0,,4071,4071,3519,3371,552,700,2209856
624,11096,33196,33196,28401,28258,4795,4938,31605.0,,27243.0,,4362.0,,31038,31038,26665,26422,4373,4616,2205508
625,11118,4614,4614,3506,3451,1108,1163,4472.0,,3697.0,,775.0,,4472,4472,3386,3246,1086,1226,2205607
626,11134,25682,25682,20835,20782,4847,4900,24356.0,,20346.0,,4010.0,,23839,23839,19480,19155,4359,4684,2205706
627,11150,19641,19641,15651,15311,3990,4330,18966.0,,16025.0,,2941.0,,18426,18426,15147,14570,3279,3856,2205805
628,11177,4613,4613,3747,3640,866,973,4460.0,,3872.0,,588.0,,4298,4298,3616,3321,682,977,2205904
629,11193,3993,3993,3172,3094,821,899,3904.0,,3456.0,,448.0,,3639,3639,3061,2840,578,799,2206001
630,11215,8725,8725,6603,6592,2122,2133,8394.0,,7068.0,,1326.0,,7798,7798,6362,6204,1436,1594,2206100
631,11231,25553,25553,19337,18963,6216,6590,24131.0,,19413.0,,4718.0,,23365,23365,18412,18281,4953,5084,2206209
632,11258,1601,1601,1354,1258,247,343,1586.0,,1474.0,,112.0,,1329,1329,1186,1059,143,270,2206308
633,11274,10002,10002,8425,8225,1577,1777,9475.0,,8156.0,,1319.0,,9150,9150,8035,7662,1115,1488,2206407
634,11290,6866,6866,5929,5816,937,1050,6383.0,,6056.0,,327.0,,6092,6092,5386,5232,706,860,2206506
635,11312,8977,8977,7088,6856,1889,2121,8416.0,,7400.0,,1016.0,,7690,7690,6485,6164,1205,1526,2206605
636,11339,6551,6551,5192,5098,1359,1453,6182.0,,5463.0,,719.0,,5529,5529,4821,4627,708,902,2206704
637,11355,8190,8190,6776,6500,1414,1690,7811.0,,6979.0,,832.0,,7220,7220,6188,5908,1032,1312,2206803
638,11371,5130,5130,4023,3944,1107,1186,4956.0,,4182.0,,774.0,,4864,4864,4022,3968,842,896,2206902
639,11398,29775,29775,24178,23760,5597,6015,28615.0,,23895.0,,4720.0,,27661,27661,22603,21692,5058,5969,2207009
640,11410,4176,4176,3345,3288,831,888,3970.0,,3531.0,,439.0,,3420,3420,2832,2698,588,722,2203420
641,11436,6007,6007,4951,4866,1056,1141,5744.0,,5106.0,,638.0,,5472,5472,4778,4617,694,855,2207207
642,11452,3847,3847,3249,3123,598,724,3662.0,,3376.0,,286.0,,3423,3423,2982,2808,441,615,2207306
643,11479,4443,4443,3719,3561,724,882,4352.0,,3878.0,,474.0,,4085,4085,3420,3329,665,756,2207405
644,11495,12320,12320,10121,9756,2199,2564,11718.0,,10101.0,,1617.0,,11246,11246,9511,8862,1735,2384,2207504
645,11517,7261,7261,5713,5597,1548,1664,6872.0,,5954.0,,918.0,,6571,6571,5525,5348,1046,1223,2207603
646,11533,109882,109882,90732,90659,19150,19223,103347.0,,83864.0,,19483.0,,102064,102064,84946,84205,17118,17859,2207702
647,11550,15948,15948,13345,13251,2603,2697,15199.0,,13495.0,,1704.0,,14856,14856,12716,12479,2140,2377,2207801
648,11576,32806,32806,24994,25062,7812,7744,30753.0,,24353.0,,6400.0,,29605,29605,23277,23267,6328,6338,2207900
649,11592,52858,52858,45134,44813,7724,8045,50898.0,,43795.0,,7103.0,,50670,50670,43383,42446,7287,8224,2208007
650,11614,8897,8897,7274,7106,1623,1791,8594.0,,7639.0,,955.0,,8284,8284,6835,6719,1449,1565,2208106
651,11630,13939,13939,11678,11718,2261,2221,13421.0,,12165.0,,1256.0,,12822,12822,11307,11019,1515,1803,2208205
652,11657,24233,24233,19563,19487,4670,4746,23197.0,,18851.0,,4346.0,,22799,22799,18168,17943,4631,4856,2208304
653,11673,51674,51674,39013,39028,12661,12646,49728.0,,37775.0,,11953.0,,49684,49684,37948,37618,11736,12066,2208403
654,11690,9136,9136,7003,6676,2133,2460,8557.0,,7027.0,,1530.0,,7906,7906,6408,6173,1498,1733,2208502
655,11711,3418,3418,2719,2568,699,850,3352.0,,2853.0,,499.0,,3088,3088,2602,2335,486,753,2208601
656,11738,6623,6623,5217,5110,1406,1513,6261.0,,5395.0,,866.0,,6044,6044,4918,4786,1126,1258,2208700
657,11754,14026,14026,10600,10439,3426,3587,13592.0,,10736.0,,2856.0,,13635,13635,10721,10218,2914,3417,2208809
658,11770,5185,5185,4208,4084,977,1101,5008.0,,4529.0,,479.0,,4882,4882,4027,3703,855,1179,2208908
659,11797,5206,5206,4203,4181,1003,1025,5015.0,,4274.0,,741.0,,4782,4782,4080,3946,702,836,2209005
660,11819,5283,5283,4617,4513,666,770,5180.0,,4767.0,,413.0,,4975,4975,4590,4373,385,602,2209104
661,11835,5073,5073,4149,4091,924,982,4858.0,,4380.0,,478.0,,4385,4385,3703,3568,682,817,2209203
662,11851,4815,4815,4122,4099,693,716,4584.0,,4289.0,,295.0,,4095,4095,3564,3558,531,537,2209302
663,11878,5734,5734,4917,4815,817,919,5549.0,,5262.0,,287.0,,4751,4751,4371,4207,380,544,2209401
664,11894,3347,3347,2795,2705,552,642,3298.0,,2913.0,,385.0,,3212,3212,2692,2556,520,656,2209500
665,11916,3701,3701,3008,2751,693,950,3721.0,,3217.0,,504.0,,3499,3499,2937,2451,562,1048,2209609
666,11932,5970,5970,4625,4481,1345,1489,5822.0,,5013.0,,809.0,,5382,5382,4504,4251,878,1131,2209708
667,11959,4625,4625,3738,3616,887,1009,4496.0,,3956.0,,540.0,,4303,4303,3708,3462,595,841,2209807
668,11975,6601,6601,5253,5031,1348,1570,6304.0,,5539.0,,765.0,,6000,6000,5116,4725,884,1275,2209906
669,11991,15021,15021,12340,12050,2681,2971,14215.0,,12284.0,,1931.0,,13798,13798,12035,11600,1763,2198,2210003
670,12009,4956,4956,3989,3848,967,1108,4739.0,,4143.0,,596.0,,4466,4466,3614,3521,852,945,2209872
671,12017,3217,3217,2502,2370,715,847,3095.0,,2776.0,,319.0,,2876,2876,2445,2311,431,565,2210102
672,12025,3940,3940,3178,3100,762,840,3808.0,,3243.0,,565.0,,3701,3701,3120,3023,581,678,2209955
673,12033,5818,5818,4772,4774,1046,1044,5736.0,,5083.0,,653.0,,5420,5420,4531,4516,889,904,2210201
674,12041,4234,4234,3485,3444,749,790,3955.0,,3548.0,,407.0,,3847,3847,3103,2977,744,870,2210623
675,12050,5281,5281,4390,4234,891,1047,5190.0,,4774.0,,416.0,,4920,4920,4417,4193,503,727,2210300
676,12068,3890,3890,3430,3426,460,464,3766.0,,3505.0,,261.0,,3533,3533,3114,3090,419,443,2210631
677,12076,15671,15671,11717,11678,3954,3993,15188.0,,12705.0,,2483.0,,14443,14443,11186,10972,3257,3471,2210409
678,12084,4405,4405,3617,3564,788,841,4201.0,,3824.0,,377.0,,3614,3614,3143,3079,471,535,2200459
679,12092,10996,10996,9105,8963,1891,2033,10552.0,,9231.0,,1321.0,,9758,9758,8728,8326,1030,1432,2210508
680,12106,7100,7100,5253,5204,1847,1896,6841.0,,6054.0,,787.0,,6221,6221,4950,4837,1271,1384,2201051
681,12114,25069,25069,21605,21424,3464,3645,23392.0,,20257.0,,3135.0,,22524,22524,19268,18936,3256,3588,2210607
682,12122,5319,5319,4560,4506,759,813,5109.0,,4710.0,,399.0,,4871,4871,4302,4171,569,700,2201739
683,12130,11517,11517,9400,9456,2117,2061,10895.0,,9404.0,,1491.0,,10588,10588,9162,8812,1426,1776,2210706
684,12149,5476,5476,4231,4143,1245,1333,5224.0,,4426.0,,798.0,,4742,4742,3984,3951,758,791,2201945
685,12157,9521,9521,8204,7964,1317,1557,9060.0,,8130.0,,930.0,,8648,8648,7579,7285,1069,1363,2210805
686,12165,4732,4732,3939,3665,793,1067,4451.0,,3892.0,,559.0,,4327,4327,3846,3475,481,852,2202554
687,12173,4204,4204,3403,3118,801,1086,4121.0,,3646.0,,475.0,,3882,3882,3253,2925,629,957,2210904
688,12181,4557,4557,3884,3827,673,730,4199.0,,3717.0,,482.0,,3965,3965,3454,3293,511,672,2203271
689,12190,589264,589264,499265,495854,89999,93410,558661.0,558661.0,446778.0,420177.0,111883.0,138484.0,556287,556287,474852,466867,81435,89420,2211001
690,12203,4585,4585,3671,3575,914,1010,4400.0,,3942.0,,458.0,,3953,3953,3421,3284,532,669,2205524
691,12211,35687,35687,30103,29662,5584,6025,34288.0,,29548.0,,4740.0,,33048,33048,28795,28323,4253,4725,2211100
692,12220,4498,4498,3708,3635,790,863,4359.0,,4006.0,,353.0,,3854,3854,3194,3096,660,758,2205599
693,12238,17455,17455,14382,14355,3073,3100,16721.0,,14288.0,,2433.0,,16122,16122,13123,12800,2999,3322,2211209
694,12246,6749,6749,5020,5115,1729,1634,6561.0,,5789.0,,772.0,,5686,5686,4563,4473,1123,1213,2206357
695,12254,16291,16291,13525,13516,2766,2775,15560.0,,13307.0,,2253.0,,15273,15273,12826,12598,2447,2675,2211308
696,12262,3413,3413,2667,2594,746,819,3339.0,,2941.0,,398.0,,3145,3145,2485,2336,660,809,2207355
697,12270,3958,3958,3091,2967,867,991,3870.0,,3440.0,,430.0,,3446,3446,2972,2791,474,655,2211407
698,12289,3795,3795,2969,2911,826,884,3704.0,,3272.0,,432.0,,3246,3246,2844,2776,402,470,2207850
699,12297,5983,5983,4964,4831,1019,1152,5824.0,,5262.0,,562.0,,5402,5402,4482,4355,920,1047,2203354
700,12300,4066,4066,3363,3261,703,805,3933.0,,3558.0,,375.0,,3690,3690,3110,3004,580,686,2208858
701,12319,5925,5925,5116,5084,809,841,5898.0,,5438.0,,460.0,,5671,5671,5010,4919,661,752,2200251
702,12327,6076,6076,5471,5402,605,674,5783.0,,5419.0,,364.0,,5479,5479,5045,4852,434,627,2200053
703,12335,2967,2967,2577,2535,390,432,2818.0,,2610.0,,208.0,,2668,2668,2396,2319,272,349,2201572
704,12343,3476,3476,2873,2656,603,820,3392.0,,3105.0,,287.0,,3028,3028,2604,2366,424,662,2202075
705,12351,4345,4345,3760,3684,585,661,4151.0,,3802.0,,349.0,,3863,3863,3512,3416,351,447,2202117
706,12360,4524,4524,3477,3507,1047,1017,4248.0,,3534.0,,714.0,,3938,3938,3323,3258,615,680,2202711
707,12378,2687,2687,2253,2210,434,477,2603.0,,2408.0,,195.0,,2440,2440,2168,2096,272,344,2204154
708,12386,3311,3311,2799,2758,512,553,3191.0,,2951.0,,240.0,,2844,2844,2533,2417,311,427,2205359
709,12394,6189,6189,5312,5150,877,1039,5978.0,,5386.0,,592.0,,5482,5482,4727,4427,755,1055,2205276
710,12408,4867,4867,3876,3783,991,1084,4691.0,,4014.0,,677.0,,4399,4399,3553,3424,846,975,2205458
711,12416,5395,5395,4561,4347,834,1048,5213.0,,4603.0,,610.0,,5113,5113,4340,4026,773,1087,2205516
712,12424,4393,4393,3781,3706,612,687,4072.0,,3672.0,,400.0,,3853,3853,3538,3344,315,509,2205581
713,12432,3124,3124,2516,2448,608,676,2948.0,,2623.0,,325.0,,2528,2528,2178,2041,350,487,2205540
714,12440,6435,6435,4785,4740,1650,1695,6210.0,,5032.0,,1178.0,,5968,5968,4694,4619,1274,1349,2205854
715,12459,5506,5506,4211,4164,1295,1342,5253.0,,4412.0,,841.0,,4994,4994,4031,3919,963,1075,2206670
716,12467,5924,5924,4841,4795,1083,1129,5631.0,,5231.0,,400.0,,5050,5050,4326,4350,724,700,2206050
717,12475,5807,5807,4740,4646,1067,1161,5508.0,,4816.0,,692.0,,5194,5194,4466,4463,728,731,2206696
718,12483,2344,2344,1875,1854,469,490,2239.0,,1976.0,,263.0,,2167,2167,1887,1828,280,339,2207108
719,12491,2725,2725,2365,2277,360,448,2622.0,,2473.0,,149.0,,2438,2438,2164,2005,274,433,2207934
720,12505,4505,4505,3954,3942,551,563,4325.0,,3993.0,,332.0,,4140,4140,3696,3649,444,491,2209658
721,12513,6319,6319,5356,5415,963,904,6238.0,,5538.0,,700.0,,5945,5945,4991,5124,954,821,2210938
722,12521,2427,2427,2012,1948,415,479,2353.0,,2099.0,,254.0,,2212,2212,1995,1858,217,354,2210979
723,12530,2644,2644,2137,2151,507,493,2575.0,,2319.0,,256.0,,2472,2472,2034,2009,438,463,2210953
724,12548,2822,2822,2489,2367,333,455,2731.0,,2555.0,,176.0,,2557,2557,2357,2267,200,290,2211605
725,12556,3340,3340,2772,2779,568,561,3265.0,,2952.0,,313.0,,3031,3031,2641,2599,390,432,2211506
726,12564,3950,3950,3481,3366,469,584,3720.0,,3547.0,,173.0,,3401,3401,3032,2975,369,426,2211704
727,12572,6810,6810,5734,5658,1076,1152,6393.0,,5558.0,,835.0,,6186,6186,5211,5105,975,1081,2202083
728,12580,4810,4810,4100,3945,710,865,4673.0,,4237.0,,436.0,,4011,4011,3569,3301,442,710,2203255
729,12599,2016,2016,1650,1569,366,447,1955.0,,1745.0,,210.0,,1871,1871,1553,1426,318,445,2208551
730,12602,3507,3507,2892,2795,615,712,3375.0,,3015.0,,360.0,,3127,3127,2763,2604,364,523,2208874
731,12610,2576,2576,2107,2046,469,530,2302.0,,2104.0,,198.0,,2045,2045,1714,1615,331,430,2209757
732,12629,2670,2670,2325,2268,345,402,2393.0,,2311.0,,82.0,,2131,2131,1940,1868,191,263,2210375
733,12637,2644,2644,2000,1986,644,658,2544.0,,2103.0,,441.0,,2457,2457,1928,1846,529,611,2203859
734,12653,1896,1896,1575,1515,321,381,1807.0,,1652.0,,155.0,,1684,1684,1484,1369,200,315,2209450
735,12661,2493,2493,2008,1966,485,527,2448.0,,2165.0,,283.0,,2304,2304,1866,1751,438,553,2210383
736,12670,4981,4981,4127,4097,854,884,4794.0,,4255.0,,539.0,,4554,4554,3861,3737,693,817,2202539
737,12688,5455,5455,4613,4457,842,998,5245.0,,4764.0,,481.0,,4910,4910,4321,4024,589,886,2202653
738,12696,5409,5409,4387,4454,1022,955,5163.0,,4513.0,,650.0,,4898,4898,4011,4170,887,728,2202729
739,12700,2928,2928,2319,2171,609,757,2836.0,,2578.0,,258.0,,2477,2477,2012,1882,465,595,2210391
740,12718,4865,4865,4144,4037,721,828,4698.0,,4287.0,,411.0,,4479,4479,3838,3604,641,875,2207793
741,12726,11231,11231,9305,9070,1926,2161,10864.0,,9359.0,,1505.0,,10266,10266,8760,8298,1506,1968,2206720
742,12734,3684,3684,3329,3286,355,398,3412.0,,3186.0,,226.0,,3325,3325,2984,2928,341,397,2200954
743,13005,18234,18234,14912,15164,3322,3070,16193.0,,14367.0,,1826.0,,13404,13404,11523,11487,1881,1917,2307254
744,13013,7216,7216,5927,5961,1289,1255,6947.0,,6143.0,,804.0,,6709,6709,5459,5670,1250,1039,2300101
745,13021,13810,13810,11424,11178,2386,2632,13203.0,,11376.0,,1827.0,,12707,12707,10681,10153,2026,2554,2307635
746,13030,45458,45458,36770,37069,8688,8389,43178.0,,37675.0,,5503.0,,39795,39795,32256,32057,7539,7738,2300200
747,13048,8387,8387,6762,6721,1625,1666,8084.0,,6831.0,,1253.0,,7908,7908,5954,5819,1954,2089,2310951
748,13056,39527,39527,31096,31501,8431,8026,38699.0,,32758.0,,5941.0,,38117,38117,29214,28945,8903,9172,2300309
749,13064,13445,13445,9581,9709,3864,3736,13396.0,,9777.0,,3619.0,,13305,13305,8967,8963,4338,4342,2304657
750,13072,11783,11783,8700,8690,3083,3093,11552.0,,9009.0,,2543.0,,11366,11366,8181,7975,3185,3391,2300408
751,13080,14299,14299,12161,11986,2138,2313,13851.0,,12423.0,,1428.0,,12838,12838,11361,10970,1477,1868,2313559
752,13099,9680,9680,7619,7660,2061,2020,9023.0,,7615.0,,1408.0,,8941,8941,7079,6976,1862,1965,2300507
753,13102,17441,17441,13274,13168,4167,4273,16936.0,,13889.0,,3047.0,,16647,16647,12105,11628,4542,5019,2311264
754,13110,6249,6249,5165,5202,1084,1047,5773.0,,5144.0,,629.0,,5467,5467,4664,4659,803,808,2300606
755,13129,17619,17619,15275,15345,2344,2274,16932.0,,15324.0,,1608.0,,16117,16117,14362,13965,1755,2152,2301950
756,13137,12800,12800,10011,10056,2789,2744,12587.0,,10424.0,,2163.0,,12322,12322,9171,9050,3151,3272,2300705
757,13145,11564,11564,10035,10139,1529,1425,11321.0,,10354.0,,967.0,,10712,10712,9504,9335,1208,1377,2300150
758,13153,7379,7379,5301,5344,2078,2035,7198.0,,5598.0,,1600.0,,6943,6943,4657,4608,2286,2335,2300804
759,13161,17167,17167,14629,14606,2538,2561,16468.0,,14681.0,,1787.0,,15885,15885,13995,13548,1890,2337,2303956
760,13170,12012,12012,10239,10142,1773,1870,11426.0,,10098.0,,1328.0,,11251,11251,9738,9326,1513,1925,2300903
761,13188,57695,57695,49009,49190,8686,8505,55018.0,,47541.0,,7477.0,,52595,52595,45094,44140,7501,8455,2305233
762,13196,61328,61328,52712,52614,8616,8714,57817.0,,50652.0,,7165.0,,54699,54699,46689,45953,8010,8746,2301000
763,13200,5705,5705,4375,4399,1330,1306,5737.0,,4784.0,,953.0,,5411,5411,3912,3810,1499,1601,2304277
764,13218,54824,54824,46743,46793,8081,8031,52721.0,,45964.0,,6757.0,,50642,50642,44230,43283,6412,7359,2301109
765,13226,49911,49911,42470,42732,7441,7179,46399.0,,39182.0,,7217.0,,41880,41880,35244,34619,6636,7261,2304285
766,13234,24030,24030,20560,20243,3470,3787,23324.0,,21045.0,,2279.0,,22615,22615,19939,18865,2676,3750,2301208
767,13242,19327,19327,16770,16679,2557,2648,18740.0,,16563.0,,2177.0,,17903,17903,15735,15448,2168,2455,2304954
768,13250,18199,18199,13224,13465,4975,4734,17653.0,,13668.0,,3985.0,,17715,17715,12420,12452,5295,5263,2301307
769,13269,5771,5771,4904,4819,867,952,5666.0,,5136.0,,530.0,,5397,5397,4290,4170,1107,1227,2311231
770,13277,11573,11573,9696,9558,1877,2015,10992.0,,9797.0,,1195.0,,10407,10407,8785,8417,1622,1990,2301406
771,13285,18636,18636,15845,16086,2791,2550,17745.0,,15566.0,,2179.0,,16613,16613,14232,14157,2381,2456,2310852
772,13293,7114,7114,5443,5268,1671,1846,7055.0,,6033.0,,1022.0,,6877,6877,5042,4639,1835,2238,2301505
773,13307,23179,23179,20011,19447,3168,3732,22515.0,,20488.0,,2027.0,,21863,21863,18977,17671,2886,4192,2309458
774,13315,19972,19972,14709,14956,5263,5016,19622.0,,15589.0,,4033.0,,19161,19161,13626,13694,5535,5467,2301604
775,13323,14859,14859,12558,12266,2301,2593,14506.0,,13108.0,,1398.0,,13855,13855,12105,11381,1750,2474,2313351
776,13331,19943,19943,15613,15814,4330,4129,19526.0,,16600.0,,2926.0,,19088,19088,15704,15487,3384,3601,2301703
777,13340,9919,9919,7791,7888,2128,2031,9429.0,,7852.0,,1577.0,,8993,8993,6836,6907,2157,2086,2305654
778,13358,5605,5605,4386,4342,1219,1263,5677.0,,4773.0,,904.0,,5441,5441,4232,4058,1209,1383,2301802
779,13366,7767,7767,5714,5740,2053,2027,7669.0,,6183.0,,1486.0,,7617,7617,5688,5521,1929,2096,2313252
780,13374,48075,48075,40167,40898,7908,7177,45490.0,,39247.0,,6243.0,,43242,43242,36130,36711,7112,6531,2301901
781,13382,14710,14710,12360,11891,2350,2819,14126.0,,12419.0,,1707.0,,13872,13872,11571,10662,2301,3210,2301851
782,13390,16708,16708,12785,12907,3923,3801,16126.0,,13250.0,,2876.0,,15566,15566,12377,12362,3189,3204,2302008
783,13404,13918,13918,11248,11016,2670,2902,12971.0,,11488.0,,1483.0,,12153,12153,10231,9989,1922,2164,2302057
784,13412,26647,26647,22390,22558,4257,4089,25538.0,,21552.0,,3986.0,,25050,25050,21014,20494,4036,4556,2302107
785,13420,9655,9655,7395,7537,2260,2118,9299.0,,7330.0,,1969.0,,8959,8959,6337,6381,2622,2578,2301257
786,13439,45021,45021,37045,36889,7976,8132,43726.0,,37043.0,,6683.0,,42456,42456,33680,32135,8776,10321,2302206
787,13447,8550,8550,6996,6942,1554,1608,8241.0,,7318.0,,923.0,,7585,7585,6484,6260,1101,1325,2303659
788,13455,20224,20224,16391,16627,3833,3597,19560.0,,16740.0,,2820.0,,19351,19351,15657,15568,3694,3783,2302305
789,13463,11299,11299,9331,8898,1968,2401,11052.0,,9663.0,,1389.0,,10389,10389,8554,8005,1835,2384,2303931
790,13471,41117,41117,33074,32235,8043,8882,39155.0,,33348.0,,5807.0,,37479,37479,31347,29851,6132,7628,2302404
791,13480,29828,29828,25877,26176,3951,3652,28123.0,,24440.0,,3683.0,,26324,26324,22934,22859,3390,3465,2306256
792,13498,35375,35375,29235,29781,6140,5594,33634.0,,27752.0,,5882.0,,32911,32911,27223,27479,5688,5432,2302503
793,13501,14630,14630,12731,12390,1899,2240,13570.0,,12154.0,,1416.0,,12538,12538,10819,10196,1719,2342,2304459
794,13510,47998,47998,38783,39081,9215,8917,45371.0,,38311.0,,7060.0,,43900,43900,36525,35668,7375,8232,2302602
795,13536,21491,21491,15688,15865,5803,5626,21141.0,,16001.0,,5140.0,,21070,21070,14700,14747,6370,6323,2302701
796,13552,57656,57656,46847,46627,10809,11029,55272.0,,45736.0,,9536.0,,53587,53587,44602,43648,8985,9939,2302800
797,13579,15793,15793,13093,13054,2700,2739,15210.0,,13453.0,,1757.0,,14810,14810,12350,11767,2460,3043,2302909
798,13595,16661,16661,14052,13465,2609,3196,15945.0,,14302.0,,1643.0,,15186,15186,13085,12025,2101,3161,2303006
799,13617,14827,14827,12012,12075,2815,2752,14272.0,,12237.0,,2035.0,,13785,13785,11163,11194,2622,2591,2303105
800,13633,24050,24050,19440,19401,4610,4649,22841.0,,19486.0,,3355.0,,21871,21871,17742,17773,4129,4098,2303204
801,13650,14953,14953,12372,12260,2581,2693,14609.0,,12672.0,,1937.0,,14099,14099,11956,11622,2143,2477,2303303
802,13676,13876,13876,10732,10943,3144,2933,12945.0,,10850.0,,2095.0,,12127,12127,9789,9920,2338,2207,2303402
803,13692,56966,56966,48220,48482,8746,8484,54723.0,,47259.0,,7464.0,,51818,51818,43827,43681,7991,8137,2303501
804,13714,9554,9554,6829,6788,2725,2766,9191.0,,7587.0,,1604.0,,8958,8958,6076,5729,2882,3229,2303600
805,13730,235150,235150,202950,203510,32200,31640,222128.0,222128.0,189148.0,180763.0,32980.0,41365.0,209053,209053,187040,184394,22013,24659,2303709
806,13757,20209,20209,16248,16128,3961,4081,19440.0,,16565.0,,2875.0,,18986,18986,15714,15487,3272,3499,2303808
807,13773,10768,10768,8444,8484,2324,2284,10332.0,,8879.0,,1453.0,,9872,9872,8208,8115,1664,1757,2303907
808,13811,19389,19389,15596,15378,3793,4011,18775.0,,16746.0,,2029.0,,17976,17976,15004,14430,2972,3546,2304004
809,13838,57514,57514,46616,46571,10898,10943,55135.0,,44598.0,,10537.0,,54654,54654,44155,43377,10499,11277,2304103
810,13854,92790,92790,80205,81053,12585,11737,86267.0,,73360.0,,12907.0,,83101,83101,72814,73301,10287,9800,2304202
811,13870,16120,16120,13772,13835,2348,2285,15386.0,,13888.0,,1498.0,,14797,14797,12804,12703,1993,2094,2304301
812,13897,1869135,1869135,1560371,1572948,308764,296187,1821382.0,1821382.0,1423608.0,1406423.0,397774.0,414959.0,1776365,1776365,1466076,1448686,310289,327679,2304400
813,13919,12631,12631,10557,10724,2074,1907,11960.0,,10765.0,,1195.0,,11366,11366,9602,9548,1764,1818,2304509
814,13935,7532,7532,6085,5942,1447,1590,7408.0,,6690.0,,718.0,,6829,6829,5867,5437,962,1392,2304608
815,13951,42392,42392,34243,34791,8149,7601,39721.0,,33630.0,,6091.0,,38869,38869,33184,32802,5685,6067,2304707
816,13978,5817,5817,4464,4430,1353,1387,5636.0,,5098.0,,538.0,,5157,5157,4098,3944,1059,1213,2304806
817,13994,8960,8960,7506,7575,1454,1385,8658.0,,7723.0,,935.0,,8169,8169,6885,6927,1284,1242,2304905
818,14010,32792,32792,25523,26347,7269,6445,30812.0,,25232.0,,5580.0,,29505,29505,23940,24233,5565,5272,2305001
819,14036,5873,5873,4914,4854,959,1019,5636.0,,5060.0,,576.0,,5162,5162,4519,4301,643,861,2305100
820,14052,14970,14970,12297,12319,2673,2651,14518.0,,12512.0,,2006.0,,13960,13960,11889,11610,2071,2350,2305209
821,14060,12129,12129,10348,9854,1781,2275,11510.0,,10391.0,,1119.0,,10862,10862,9555,8827,1307,2035,2305266
822,14079,18689,18689,14970,15208,3719,3481,17517.0,,14504.0,,3013.0,,16989,16989,13214,13377,3775,3612,2305308
823,14095,49185,49185,38698,38553,10487,10632,47494.0,,38565.0,,8929.0,,46357,46357,38218,37051,8139,9306,2305407
824,14117,68464,68464,58022,58497,10442,9967,65600.0,,56894.0,,8706.0,,63541,63541,54435,53866,9106,9675,2305506
825,14133,21885,21885,16712,16472,5173,5413,21655.0,,17550.0,,4105.0,,21765,21765,15761,15180,6004,6585,2305605
826,14150,9577,9577,7475,7508,2102,2069,9323.0,,7648.0,,1675.0,,9454,9454,7154,7185,2300,2269,2305704
827,14176,34669,34669,25855,26281,8814,8388,33898.0,,25799.0,,8099.0,,33700,33700,23797,23608,9903,10092,2305803
828,14192,33912,33912,23537,23761,10375,10151,33214.0,,24240.0,,8974.0,,33076,33076,21316,21032,11760,12044,2305902
829,14214,11999,11999,9265,9257,2734,2742,11664.0,,9418.0,,2246.0,,11776,11776,8712,8495,3064,3281,2306009
830,14230,18380,18380,15667,15591,2713,2789,17414.0,,15404.0,,2010.0,,16134,16134,14010,13442,2124,2692,2306108
831,14257,6841,6841,5879,5840,962,1001,6647.0,,6116.0,,531.0,,6443,6443,5573,5403,870,1040,2306207
832,14273,37772,37772,32217,32442,5555,5330,37088.0,,32315.0,,4773.0,,35583,35583,30908,30367,4675,5216,2306306
833,14290,93393,93393,79908,78868,13485,14525,87901.0,,76347.0,,11554.0,,83614,83614,72947,70696,10667,12918,2306405
834,14311,15672,15672,12908,12680,2764,2992,15083.0,,13288.0,,1795.0,,14670,14670,12297,11589,2373,3081,2306504
835,14338,18520,18520,14285,14090,4235,4430,17297.0,,14882.0,,2415.0,,16768,16768,13873,13200,2895,3568,2306603
836,14354,15710,15710,12345,12271,3365,3439,15475.0,,12662.0,,2813.0,,15505,15505,11501,10839,4004,4666,2306702
837,14370,8660,8660,7045,7023,1615,1637,8480.0,,7302.0,,1178.0,,7926,7926,6297,6095,1629,1831,2306801
838,14397,28507,28507,22661,22692,5846,5815,27584.0,,22579.0,,5005.0,,27319,27319,22271,21922,5048,5397,2306900
839,14419,27649,27649,23149,23273,4500,4376,26815.0,,23700.0,,3115.0,,26230,26230,22204,21744,4026,4486,2307007
840,14435,21883,21883,16466,17275,5417,4608,20996.0,,17267.0,,3729.0,,20040,20040,15463,15840,4577,4200,2307106
841,14451,6814,6814,5396,5454,1418,1360,6681.0,,5783.0,,898.0,,6436,6436,5268,5228,1168,1208,2307205
842,14478,183286,183286,154183,155635,29103,27651,174604.0,,143931.0,,30673.0,,168958,168958,141757,142033,27201,26925,2307304
843,14494,19657,19657,15200,15547,4457,4110,19092.0,,15958.0,,3134.0,,18419,18419,14525,14386,3894,4033,2307403
844,14516,23336,23336,18295,18360,5041,4976,22541.0,,18731.0,,3810.0,,21841,21841,17601,17462,4240,4379,2307502
845,14532,45707,45707,38890,39346,6817,6361,43655.0,,36979.0,,6676.0,,42372,42372,36134,36032,6238,6340,2307601
846,14559,79353,79353,68376,68273,10977,11080,75876.0,,65873.0,,10003.0,,73288,73288,64384,63093,8904,10195,2307700
847,14575,21981,21981,18205,18345,3776,3636,21015.0,,18725.0,,2290.0,,20576,20576,17364,16879,3212,3697,2307809
848,14591,9983,9983,8536,8356,1447,1627,9316.0,,8530.0,,786.0,,8767,8767,7865,7423,902,1344,2307908
849,14613,31945,31945,25607,25799,6338,6146,31087.0,,26214.0,,4873.0,,29652,29652,23145,22793,6507,6859,2308005
850,14630,34378,34378,27742,28220,6636,6158,32937.0,,27937.0,,5000.0,,31998,31998,26518,26758,5480,5240,2308104
851,14656,12125,12125,10394,10473,1731,1652,11393.0,,10219.0,,1174.0,,10739,10739,9380,9311,1359,1428,2308203
852,14672,21959,21959,17560,17653,4399,4306,21316.0,,17928.0,,3388.0,,20905,20905,16977,16948,3928,3957,2308302
853,14680,11571,11571,9583,9409,1988,2162,10901.0,,9815.0,,1086.0,,10524,10524,8788,8273,1736,2251,2308377
854,14699,29154,29154,23933,24571,5221,4583,27616.0,,23996.0,,3620.0,,26745,26745,21272,22542,5473,4203,2308401
855,14710,31890,31890,24863,25141,7027,6749,30664.0,,25086.0,,5578.0,,30088,30088,23934,23618,6154,6470,2308500
856,14737,15753,15753,11397,11350,4356,4403,15532.0,,12313.0,,3219.0,,15412,15412,10949,10890,4463,4522,2308609
857,14753,54557,54557,45643,45236,8914,9321,52660.0,,45336.0,,7324.0,,50696,50696,43435,41491,7261,9205,2308708
858,14770,7529,7529,6294,6099,1235,1430,7340.0,,6679.0,,661.0,,6912,6912,5913,5640,999,1272,2308807
859,14796,17436,17436,14285,14256,3151,3180,16962.0,,15205.0,,1757.0,,16643,16643,13197,12521,3446,4122,2308906
860,14818,13649,13649,9612,9773,4037,3876,13350.0,,10162.0,,3188.0,,13349,13349,8999,9033,4350,4316,2309003
861,14834,8672,8672,7205,7189,1467,1483,8191.0,,7186.0,,1005.0,,7923,7923,6586,6394,1337,1529,2309102
862,14850,12062,12062,9990,10119,2072,1943,11723.0,,10081.0,,1642.0,,11482,11482,9642,9754,1840,1728,2309201
863,14877,25448,25448,19014,19150,6434,6298,24744.0,,19232.0,,5512.0,,24157,24157,17305,16842,6852,7315,2309300
864,14893,23988,23988,17705,17978,6283,6010,23395.0,,19375.0,,4020.0,,22624,22624,16436,16096,6188,6528,2309409
865,14915,18976,18976,13908,13982,5068,4994,18579.0,,13837.0,,4742.0,,18749,18749,13484,13301,5265,5448,2309508
866,14931,51296,51296,44368,44421,6928,6875,49456.0,,43369.0,,6087.0,,46362,46362,40878,40073,5484,6289,2309607
867,14958,51651,51651,44818,44928,6833,6723,48626.0,,43226.0,,5400.0,,42349,42349,37896,37312,4453,5037,2309706
868,14974,10363,10363,8521,8478,1842,1885,10246.0,,8993.0,,1253.0,,9765,9765,8199,7824,1566,1941,2309805
869,14990,6398,6398,4914,4801,1484,1597,6214.0,,5224.0,,990.0,,5989,5989,4535,4360,1454,1629,2309904
870,15016,8913,8913,7580,7510,1333,1403,8674.0,,7903.0,,771.0,,8056,8056,6982,6716,1074,1340,2310001
871,15032,9250,9250,7700,7660,1550,1590,8923.0,,7809.0,,1114.0,,8554,8554,7163,6789,1391,1765,2310100
872,15059,31171,31171,26092,26058,5079,5113,29492.0,,25044.0,,4448.0,,28406,28406,24540,24064,3866,4342,2310209
873,15075,28685,28685,20528,20224,8157,8461,28363.0,,21608.0,,6755.0,,28020,28020,19022,17817,8998,10203,2310308
874,15091,9801,9801,8262,8078,1539,1723,9438.0,,8285.0,,1153.0,,9090,9090,7810,7332,1280,1758,2310407
875,15113,33697,33697,26069,25917,7628,7780,32321.0,,26292.0,,6029.0,,31485,31485,25185,25074,6300,6411,2310506
876,15130,8003,8003,6726,6773,1277,1230,7552.0,,6829.0,,723.0,,7369,7369,6280,6230,1089,1139,2310605
877,15156,31404,31404,26543,26451,4861,4953,30773.0,,26625.0,,4148.0,,30043,30043,26325,25349,3718,4694,2310704
878,15172,15361,15361,11276,11451,4085,3910,14990.0,,11567.0,,3423.0,,14614,14614,10312,10289,4302,4325,2310803
879,15199,11921,11921,9721,9935,2200,1986,11519.0,,9835.0,,1684.0,,11027,11027,8455,8479,2572,2548,2310902
880,15210,10533,10533,7587,7668,2946,2865,10439.0,,8065.0,,2374.0,,10081,10081,6978,6991,3103,3090,2311009
881,15237,13894,13894,10964,11230,2930,2664,13540.0,,11504.0,,2036.0,,12823,12823,10191,10321,2632,2502,2311108
882,15253,7772,7772,6060,6060,1712,1712,7595.0,,6206.0,,1389.0,,7451,7451,5604,5512,1847,1939,2311207
883,15270,58649,58649,49074,48716,9575,9933,55981.0,,47695.0,,8286.0,,54240,54240,46743,45233,7497,9007,2311306
884,15296,60071,60071,47608,47461,12463,12610,58944.0,,48018.0,,10926.0,,56473,56473,43216,41129,13257,15344,2311405
885,15318,17644,17644,14865,15099,2779,2545,17171.0,,15146.0,,2025.0,,16430,16430,13834,13634,2596,2796,2311504
886,15334,23131,23131,19319,19465,3812,3666,22663.0,,19551.0,,3112.0,,21876,21876,18983,18457,2893,3419,2311603
887,15350,16813,16813,12592,12678,4221,4135,16503.0,,12913.0,,3590.0,,16387,16387,11398,11171,4989,5216,2311702
888,15377,56412,56412,47851,48074,8561,8338,55001.0,,47689.0,,7312.0,,53371,53371,46034,45316,7337,8055,2311801
889,15393,13100,13100,9540,9522,3560,3578,12946.0,,10022.0,,2924.0,,13430,13430,9337,9081,4093,4349,2311900
890,15415,25886,25886,21052,20702,4834,5184,25043.0,,21456.0,,3587.0,,25162,25162,20019,19019,5143,6143,2312007
891,15431,13171,13171,10882,11013,2289,2158,12490.0,,10865.0,,1625.0,,12414,12414,10339,10435,2075,1979,2312106
892,15440,14201,14201,11031,11147,3170,3054,13830.0,,11241.0,,2589.0,,13122,13122,9897,10008,3225,3114,2311959
893,15458,33128,33128,27258,27153,5870,5975,31597.0,,26946.0,,4651.0,,30572,30572,25732,25033,4840,5539,2312205
894,15474,36308,36308,28751,29517,7557,6791,34379.0,,28192.0,,6187.0,,33229,33229,27487,27857,5742,5372,2312304
895,15490,45801,45801,38877,38808,6924,6993,42742.0,,37326.0,,5416.0,,40196,40196,34866,34066,5330,6130,2312403
896,15512,6627,6627,4923,4990,1704,1637,6911.0,,5775.0,,1136.0,,6944,6944,5192,5125,1752,1819,2312502
897,15539,11305,11305,9341,9185,1964,2120,11109.0,,9690.0,,1419.0,,10669,10669,9180,8650,1489,2019,2312601
898,15555,21413,21413,16822,16864,4591,4549,21094.0,,17029.0,,4065.0,,21474,21474,15715,15312,5759,6162,2312700
899,15571,6704,6704,5519,5305,1185,1399,6303.0,,5664.0,,639.0,,6053,6053,5036,4605,1017,1448,2312809
900,15598,148145,148145,125490,125774,22655,22371,142091.0,,121470.0,,20621.0,,137510,137510,118854,116190,18656,21320,2312908
901,15610,14895,14895,11623,11527,3272,3368,14659.0,,12075.0,,2584.0,,14843,14843,10739,10265,4104,4578,2313005
902,15636,25991,25991,20263,20685,5728,5306,25641.0,,20242.0,,5399.0,,25427,25427,19642,19617,5785,5810,2313104
903,15652,22441,22441,17046,17110,5395,5331,21892.0,,17733.0,,4159.0,,21284,21284,15554,15152,5730,6132,2313203
904,15679,47620,47620,36432,36005,11188,11615,46525.0,,36702.0,,9823.0,,45714,45714,34028,32146,11686,13568,2313302
905,15695,55305,55305,47008,47890,8297,7415,52391.0,,45156.0,,7235.0,,51147,51147,43780,44010,7367,7137,2313401
906,15717,45199,45199,37933,37223,7266,7976,42558.0,,36956.0,,5602.0,,40362,40362,34140,32692,6222,7670,2313500
907,15733,25122,25122,20828,21316,4294,3806,23907.0,,20290.0,,3617.0,,22834,22834,18992,19154,3842,3680,2313609
908,15750,6460,6460,4962,5009,1498,1451,6273.0,,5209.0,,1064.0,,6357,6357,4673,4637,1684,1720,2313708
909,15776,17495,17495,14824,14847,2671,2648,16414.0,,14621.0,,1793.0,,15897,15897,14054,13795,1843,2102,2313807
910,15792,10806,10806,9000,8951,1806,1855,10433.0,,9247.0,,1186.0,,9977,9977,8672,8273,1305,1704,2313906
911,15814,31399,31399,25292,25703,6107,5696,29928.0,,24630.0,,5298.0,,29349,29349,23400,23808,5949,5541,2314003
912,15830,45659,45659,36818,37535,8841,8124,43226.0,,36530.0,,6696.0,,42123,42123,34314,34779,7809,7344,2314102
913,15857,168849,168849,148595,149580,20254,19269,160798.0,,141063.0,,19735.0,,151212,151212,134903,133943,16309,17269,2307650
914,15873,33515,33515,27126,26690,6389,6825,31716.0,,27574.0,,4142.0,,30150,30150,24622,23335,5528,6815,2300754
915,15881,14504,14504,11162,11448,3342,3056,13706.0,,11589.0,,2117.0,,12657,12657,10366,10983,2291,1674,2304236
916,15890,21415,21415,17458,17983,3957,3432,19850.0,,17068.0,,2782.0,,18356,18356,15261,15428,3095,2928,2304251
917,15911,18593,18593,15859,15813,2734,2780,17923.0,,15966.0,,1957.0,,17498,17498,14968,14604,2530,2894,2304350
918,15920,12057,12057,10099,9896,1958,2161,11950.0,,11076.0,,874.0,,10730,10730,9423,8834,1307,1896,2305332
919,15938,16509,16509,14250,14178,2259,2331,15849.0,,14184.0,,1665.0,,15137,15137,13216,12902,1921,2235,2305357
920,15954,31658,31658,25336,25385,6322,6273,30050.0,,25602.0,,4448.0,,29048,29048,23582,22774,5466,6274,2306553
921,15970,11632,11632,9046,9109,2586,2523,11400.0,,9500.0,,1900.0,,11527,11527,8411,8081,3116,3446,2308351
922,15989,7460,7460,5989,5967,1471,1493,7351.0,,6211.0,,1140.0,,7228,7228,5430,5392,1798,1836,2304269
923,15997,25478,25478,21848,21741,3630,3737,24423.0,,21681.0,,2742.0,,23248,23248,20244,19698,3004,3550,2310258
924,16004,5085,5085,4255,4305,830,780,4913.0,,4473.0,,440.0,,4638,4638,4040,3931,598,707,2414159
925,16012,9227,9227,7436,7535,1791,1692,9089.0,,7513.0,,1576.0,,8874,8874,7191,7037,1683,1837,2400109
926,16020,11211,11211,9718,9508,1493,1703,10442.0,,9576.0,,866.0,,9648,9648,8188,7746,1460,1902,2413359
927,16039,43450,43450,35819,35961,7631,7489,42162.0,,35717.0,,6445.0,,41799,41799,34407,33430,7392,8369,2400208
928,16047,5185,5185,4309,4123,876,1062,4962.0,,4558.0,,404.0,,4675,4675,3924,3619,751,1056,2401859
929,16055,9862,9862,8005,7559,1857,2303,9480.0,,8452.0,,1028.0,,9280,9280,7578,6748,1702,2532,2400307
930,16063,8743,8743,7235,7228,1508,1515,8222.0,,7392.0,,830.0,,7508,7508,6294,6141,1214,1367,2412559
931,16071,2791,2791,2343,2364,448,427,2753.0,,2560.0,,193.0,,2551,2551,2140,2151,411,400,2400406
932,16080,6589,6589,5333,5240,1256,1349,6476.0,,5581.0,,895.0,,6295,6295,5154,4988,1141,1307,2404853
933,16098,11333,11333,9191,8934,2142,2399,10938.0,,9236.0,,1702.0,,10802,10802,8531,8390,2271,2412,2400505
934,16101,3597,3597,2773,2764,824,833,3394.0,,3015.0,,379.0,,2958,2958,2456,2387,502,571,2401651
935,16110,5191,5191,4378,4146,813,1045,5069.0,,4661.0,,408.0,,4885,4885,4064,3663,821,1222,2400604
936,16128,3998,3998,3366,3237,632,761,3885.0,,3623.0,,262.0,,3655,3655,3147,2923,508,732,2414456
937,16136,11362,11362,9193,9185,2169,2177,10806.0,,9096.0,,1710.0,,10627,10627,8794,8712,1833,1915,2400703
938,16144,3133,3133,2694,2514,439,619,3075.0,,2822.0,,253.0,,2807,2807,2449,2299,358,508,2403756
939,16152,9863,9863,8201,8003,1662,1860,9462.0,,8256.0,,1206.0,,9032,9032,7636,7337,1396,1695,2400802
940,16160,3084,3084,2570,2551,514,533,2929.0,,2542.0,,387.0,,2802,2802,2368,2387,434,415,2407252
941,16179,5669,5669,4870,4657,799,1012,5457.0,,4785.0,,672.0,,5329,5329,4663,4432,666,897,2400901
942,16187,3879,3879,2952,2893,927,986,3764.0,,3265.0,,499.0,,3373,3373,2700,2565,673,808,2414753
943,16195,28981,28981,24843,25111,4138,3870,27807.0,,24138.0,,3669.0,,26886,26886,23132,23197,3754,3689,2401008
944,16209,4062,4062,3444,3471,618,591,3895.0,,3413.0,,482.0,,3726,3726,3114,3155,612,571,2413557
945,16217,21339,21339,17182,17245,4157,4094,20974.0,,18303.0,,2671.0,,20431,20431,16479,16224,3952,4207,2401107
946,16225,6623,6623,5353,5380,1270,1243,5619.0,,5068.0,,551.0,,4814,4814,3901,3776,913,1038,2411056
947,16233,10926,10926,9190,9383,1736,1543,10595.0,,9577.0,,1018.0,,10302,10302,8935,9007,1367,1295,2401206
948,16241,4507,4507,3745,3661,762,846,4373.0,,3938.0,,435.0,,4154,4154,3473,3411,681,743,2409332
949,16250,8546,8546,7119,6938,1427,1608,8265.0,,7294.0,,971.0,,8026,8026,6647,6314,1379,1712,2401305
950,16268,9816,9816,8265,7915,1551,1901,9368.0,,8502.0,,866.0,,8549,8549,7413,7085,1136,1464,2408953
951,16276,7130,7130,5669,5602,1461,1528,6968.0,,6161.0,,807.0,,6671,6671,5450,5312,1221,1359,2401404
952,16284,4844,4844,4024,3899,820,945,4775.0,,4354.0,,421.0,,4488,4488,3762,3580,726,908,2410256
953,16292,4639,4639,3774,3692,865,947,4627.0,,4158.0,,469.0,,4413,4413,3619,3371,794,1042,2401503
954,16306,4225,4225,3474,3309,751,916,4216.0,,3925.0,,291.0,,3737,3737,3018,2961,719,776,2406155
955,16314,4807,4807,4045,3945,762,862,4615.0,,4122.0,,493.0,,4418,4418,3854,3679,564,739,2401602
956,16330,8695,8695,7052,7097,1643,1598,8306.0,,6936.0,,1370.0,,7717,7717,6219,6046,1498,1671,2401701
957,16357,10066,10066,7965,8118,2101,1948,9734.0,,8413.0,,1321.0,,9496,9496,7778,7818,1718,1678,2401800
958,16373,3659,3659,3143,2991,516,668,3531.0,,3269.0,,262.0,,3331,3331,2958,2660,373,671,2401909
959,16390,44722,44722,37373,38028,7349,6694,43335.0,,35998.0,,7337.0,,42795,42795,35785,35367,7010,7428,2402006
960,16411,8250,8250,6823,6668,1427,1582,7790.0,,6767.0,,1023.0,,7452,7452,6259,6090,1193,1362,2402105
961,16438,24006,24006,19115,19220,4891,4786,23128.0,,19618.0,,3510.0,,22793,22793,18717,18559,4076,4234,2402204
962,16454,19004,19004,15492,15514,3512,3490,18378.0,,15477.0,,2901.0,,18219,18219,14590,14405,3629,3814,2402303
963,16470,5990,5990,5007,5185,983,805,5815.0,,5214.0,,601.0,,5687,5687,4829,4923,858,764,2402402
964,16497,8721,8721,7223,7193,1498,1528,8583.0,,7637.0,,946.0,,8460,8460,7079,6854,1381,1606,2402501
965,16519,56407,56407,46581,46664,9826,9743,53136.0,,44309.0,,8827.0,,51506,51506,43105,42513,8401,8993,2402600
966,16535,9170,9170,7137,7178,2033,1992,8783.0,,7472.0,,1311.0,,8447,8447,6945,6732,1502,1715,2402709
967,16551,4755,4755,3676,3589,1079,1166,4644.0,,3915.0,,729.0,,4463,4463,3709,3514,754,949,2402808
968,16578,4023,4023,3262,3230,761,793,3892.0,,3323.0,,569.0,,3755,3755,2988,2964,767,791,2402907
969,16594,6805,6805,5488,5555,1317,1250,6785.0,,5904.0,,881.0,,6608,6608,5240,5218,1368,1390,2403004
970,16616,31733,31733,25359,25732,6374,6001,30600.0,,24827.0,,5773.0,,30007,30007,24567,24186,5440,5821,2403103
971,16632,5893,5893,4932,4940,961,953,5611.0,,4919.0,,692.0,,5262,5262,4409,4409,853,853,2403202
972,16659,4734,4734,3989,3998,745,736,4509.0,,3936.0,,573.0,,4363,4363,3561,3592,802,771,2403301
973,16675,4648,4648,3871,3848,777,800,4511.0,,3980.0,,531.0,,4465,4465,3652,3587,813,878,2403400
974,16691,7546,7546,6032,6131,1514,1415,7184.0,,6118.0,,1066.0,,6888,6888,5782,5762,1106,1126,2403509
975,16713,28032,28032,23737,23787,4295,4245,24189.0,,20678.0,,3511.0,,20521,20521,18017,17851,2504,2670,2403608
976,16730,6687,6687,5857,5857,830,830,6470.0,,6050.0,,420.0,,6309,6309,5526,5460,783,849,2403707
977,16756,8098,8098,6788,6680,1310,1418,7790.0,,6794.0,,996.0,,7543,7543,6364,6165,1179,1378,2403806
978,16772,2791,2791,2317,2322,474,469,2744.0,,2461.0,,283.0,,2635,2635,2096,2123,539,512,2403905
979,16799,2562,2562,2164,1904,398,658,2521.0,,2329.0,,192.0,,2354,2354,1889,1679,465,675,2404101
980,16810,21049,21049,17276,17508,3773,3541,20172.0,,17420.0,,2752.0,,19138,19138,16227,16253,2911,2885,2404200
981,16837,11909,11909,9903,9907,2006,2002,11638.0,,10012.0,,1626.0,,11356,11356,9263,9148,2093,2208,2404309
982,16853,8757,8757,7562,7499,1195,1258,8565.0,,7959.0,,606.0,,7967,7967,6818,6756,1149,1211,2404408
983,16870,15283,15283,12173,11971,3110,3312,14474.0,,12857.0,,1617.0,,13726,13726,11035,10801,2691,2925,2404507
984,16896,10951,10951,9065,8908,1886,2043,10689.0,,9513.0,,1176.0,,10202,10202,8415,8116,1787,2086,2404606
985,16918,12590,12590,10343,10336,2247,2254,12291.0,,10746.0,,1545.0,,11906,11906,9612,9479,2294,2427,2404705
986,16934,2003,2003,1737,1701,266,302,1976.0,,1883.0,,93.0,,1781,1781,1617,1560,164,221,2404804
987,16950,4953,4953,4098,4041,855,912,4778.0,,4396.0,,382.0,,4477,4477,3669,3676,808,801,2404903
988,16977,6039,6039,4895,4905,1144,1134,5694.0,,4913.0,,781.0,,5500,5500,4623,4611,877,889,2405009
989,16993,5615,5615,4814,4642,801,973,5348.0,,4835.0,,513.0,,5178,5178,4525,4265,653,913,2405108
990,17019,4350,4350,3606,3520,744,830,4278.0,,3818.0,,460.0,,4117,4117,3376,3243,741,874,2405207
991,17035,7499,7499,6206,6109,1293,1390,7304.0,,6459.0,,845.0,,6930,6930,5814,5589,1116,1341,2405306
992,17051,5522,5522,4441,4436,1081,1086,5366.0,,4681.0,,685.0,,5097,5097,4264,4196,833,901,2405405
993,17078,2839,2839,2460,2252,379,587,2654.0,,2482.0,,172.0,,2507,2507,2107,2016,400,491,2405504
994,17094,10501,10501,8887,8899,1614,1602,10300.0,,8992.0,,1308.0,,10297,10297,8344,8330,1953,1967,2405603
995,17116,10001,10001,8502,8590,1499,1411,9774.0,,8501.0,,1273.0,,9711,9711,8369,8299,1342,1412,2405702
996,17132,25369,25369,21267,20923,4102,4446,23959.0,,20676.0,,3283.0,,22916,22916,19543,19158,3373,3758,2405801
997,17159,3175,3175,2518,2157,657,1018,3078.0,,2748.0,,330.0,,2669,2669,2234,1976,435,693,2405900
998,17175,5215,5215,4255,4281,960,934,5081.0,,4537.0,,544.0,,4793,4793,3936,3946,857,847,2406007
999,17191,15059,15059,12646,12497,2413,2562,14572.0,,12701.0,,1871.0,,14025,14025,12130,11446,1895,2579,2406106
1000,17213,4429,4429,3843,3695,586,734,4212.0,,3999.0,,213.0,,4020,4020,3585,3321,435,699,2407609
1001,17230,5682,5682,4619,4602,1063,1080,5310.0,,4754.0,,556.0,,4833,4833,3992,3983,841,850,2406205
1002,17256,7354,7354,5945,5952,1409,1402,7036.0,,6184.0,,852.0,,6515,6515,5323,5303,1192,1212,2406304
1003,17272,3200,3200,2610,2564,590,636,3200.0,,2855.0,,345.0,,3187,3187,2606,2420,581,767,2406403
1004,17299,12222,12222,9633,9791,2589,2431,11814.0,,9861.0,,1953.0,,11432,11432,9231,9183,2201,2249,2406502
1005,17310,9335,9335,7531,7692,1804,1643,9118.0,,8138.0,,980.0,,8603,8603,6939,6912,1664,1691,2406601
1006,17337,8827,8827,7222,7030,1605,1797,8440.0,,7092.0,,1348.0,,8215,8215,6950,6465,1265,1750,2406700
1007,17353,5073,5073,4274,4131,799,942,4884.0,,4428.0,,456.0,,4627,4627,3929,3775,698,852,2406809
1008,17370,3378,3378,2908,2813,470,565,3277.0,,2926.0,,351.0,,3264,3264,2663,2549,601,715,2406908
1009,17396,7440,7440,5820,5770,1620,1670,7182.0,,5998.0,,1184.0,,6871,6871,5590,5589,1281,1282,2407005
1010,17418,52343,52343,43388,43671,8955,8672,50091.0,,41398.0,,8693.0,,49803,49803,40679,40576,9124,9227,2407104
1011,17434,22419,22419,17717,17492,4702,4927,22152.0,,17987.0,,4165.0,,22076,22076,17360,16769,4716,5307,2407203
1012,17450,6738,6738,5704,5667,1034,1071,6558.0,,5934.0,,624.0,,6172,6172,5235,5157,937,1015,2407302
1013,17477,6929,6929,5672,5782,1257,1147,6564.0,,5820.0,,744.0,,6375,6375,5179,5222,1196,1153,2407401
1014,17493,9281,9281,7729,7556,1552,1725,8750.0,,7885.0,,865.0,,8028,8028,6952,6690,1076,1338,2407500
1015,17515,4103,4103,3369,3283,734,820,3944.0,,3317.0,,627.0,,3917,3917,3075,2847,842,1070,2404002
1016,17531,9108,9108,7318,7409,1790,1699,8584.0,,7377.0,,1207.0,,8156,8156,6977,7030,1179,1126,2407708
1017,17558,17077,17077,13830,14141,3247,2936,16359.0,,13852.0,,2507.0,,16267,16267,13020,13020,3247,3247,2407807
1018,17574,2740,2740,2292,2200,448,540,2675.0,,2387.0,,288.0,,2410,2410,2125,2043,285,367,2407906
1019,17590,183285,183285,150013,155784,33272,27501,175932.0,,145751.0,,30181.0,,174189,174189,144211,145031,29978,29158,2408003
1020,17612,583079,583079,465858,481010,117221,102069,560929.0,,402957.0,,157972.0,,557109,557109,454202,456353,102907,100756,2408102
1021,17639,21183,21183,17439,17311,3744,3872,20121.0,,16798.0,,3323.0,,20012,20012,16192,15657,3820,4355,2408201
1022,17655,26548,26548,21342,21847,5206,4701,25345.0,,21676.0,,3669.0,,24218,24218,19907,20349,4311,3869,2408300
1023,17671,4368,4368,3603,3569,765,799,4332.0,,3983.0,,349.0,,4012,4012,3464,3233,548,779,2408409
1024,17698,4228,4228,3658,3618,570,610,4127.0,,3704.0,,423.0,,3925,3925,3482,3432,443,493,2408508
1025,17710,4106,4106,3243,3191,863,915,4069.0,,3813.0,,256.0,,3246,3246,2791,2702,455,544,2408607
1026,17736,4325,4325,3679,3431,646,894,4224.0,,3901.0,,323.0,,4127,4127,3545,3153,582,974,2408706
1027,17752,5067,5067,4218,4122,849,945,4834.0,,4506.0,,328.0,,4545,4545,3897,3763,648,782,2408805
1028,17779,16903,16903,14374,14433,2529,2470,16516.0,,14556.0,,1960.0,,16454,16454,13772,13635,2682,2819,2408904
1029,17795,136655,136655,113392,115521,23263,21134,125346.0,,96433.0,,28913.0,,119014,119014,101800,101480,17214,17534,2403251
1030,17817,9275,9275,7672,7723,1603,1552,8804.0,,7703.0,,1101.0,,8626,8626,7175,7211,1451,1415,2409100
1031,17833,3491,3491,3082,2973,409,518,3332.0,,3153.0,,179.0,,2980,2980,2700,2676,280,304,2409209
1032,17850,9404,9404,7963,7853,1441,1551,9074.0,,8042.0,,1032.0,,8748,8748,7471,7357,1277,1391,2409308
1033,17876,20326,20326,17190,17209,3136,3117,19346.0,,16418.0,,2928.0,,19443,19443,15776,15846,3667,3597,2409407
1034,17892,4027,4027,3345,3121,682,906,3872.0,,3609.0,,263.0,,3640,3640,3097,2782,543,858,2409506
1035,17914,3218,3218,2711,2508,507,710,3186.0,,3037.0,,149.0,,2713,2713,2449,2139,264,574,2409605
1036,17930,6634,6634,4919,4640,1715,1994,6726.0,,5536.0,,1190.0,,6931,6931,4952,4105,1979,2826,2409704
1037,17957,11605,11605,9398,9429,2207,2176,11103.0,,9600.0,,1503.0,,10442,10442,8737,8684,1705,1758,2409803
1038,17973,10729,10729,8844,8704,1885,2025,10351.0,,9042.0,,1309.0,,10240,10240,8313,8166,1927,2074,2409902
1039,17990,3570,3570,2814,2737,756,833,3593.0,,3172.0,,421.0,,3461,3461,2657,2448,804,1013,2410009
1040,18015,11025,11025,9154,8999,1871,2026,10467.0,,9292.0,,1175.0,,9942,9942,8585,8392,1357,1550,2410108
1041,18031,6379,6379,5440,5414,939,965,5943.0,,5430.0,,513.0,,5728,5728,4868,4811,860,917,2410207
1042,18058,8349,8349,6817,6882,1532,1467,7777.0,,6790.0,,987.0,,7211,7211,6012,5948,1199,1263,2410306
1043,18074,7874,7874,6391,6282,1483,1592,7635.0,,6740.0,,895.0,,7234,7234,5989,5671,1245,1563,2410405
1044,18090,4813,4813,4097,4156,716,657,4665.0,,4308.0,,357.0,,4325,4325,3552,3586,773,739,2410504
1045,18112,2788,2788,2382,2304,406,484,2726.0,,2521.0,,205.0,,2640,2640,2300,2174,340,466,2410702
1046,18139,3750,3750,3140,3163,610,587,3605.0,,3219.0,,386.0,,3410,3410,2713,2715,697,695,2410801
1047,18155,6221,6221,5356,5302,865,919,5987.0,,5515.0,,472.0,,5535,5535,4908,4822,627,713,2410900
1048,18171,4171,4171,3503,3481,668,690,4038.0,,3736.0,,302.0,,3777,3777,3296,3157,481,620,2411007
1049,18198,3956,3956,3238,3080,718,876,3886.0,,3547.0,,339.0,,3743,3743,3025,2671,718,1072,2411106
1050,18210,4016,4016,3257,3308,759,708,3911.0,,3539.0,,372.0,,3798,3798,3030,3229,768,569,2411908
1051,18236,26025,26025,21581,21759,4444,4266,24536.0,,20495.0,,4041.0,,23724,23724,20413,20021,3311,3703,2411205
1052,18252,2574,2574,2239,2225,335,349,2492.0,,2299.0,,193.0,,2428,2428,2108,2093,320,335,2411429
1053,18279,11222,11222,9158,8899,2064,2323,10961.0,,9303.0,,1658.0,,10911,10911,9010,8615,1901,2296,2411403
1054,18295,17839,17839,14974,15168,2865,2671,16917.0,,15105.0,,1812.0,,16293,16293,14079,14113,2214,2180,2411502
1055,18317,3715,3715,3081,2946,634,769,3521.0,,3262.0,,259.0,,3220,3220,2638,2475,582,745,2411601
1056,18333,4224,4224,3348,3339,876,885,4073.0,,3539.0,,534.0,,3810,3810,3166,3084,644,726,2411700
1057,18350,3485,3485,3028,3023,457,462,3365.0,,3093.0,,272.0,,3310,3310,2857,2760,453,550,2411809
1058,18376,72923,72923,60992,61692,11931,11231,69027.0,,58485.0,,10542.0,,65066,65066,55930,54961,9136,10105,2412005
1059,18392,5177,5177,4459,4456,718,721,4969.0,,4512.0,,457.0,,4774,4774,4186,4151,588,623,2412104
1060,18414,32622,32622,26393,26726,6229,5896,30873.0,,25535.0,,5338.0,,30000,30000,24067,23815,5933,6185,2412203
1061,18430,10214,10214,8325,8256,1889,1958,9905.0,,8605.0,,1300.0,,9666,9666,7784,7599,1882,2067,2412302
1062,18457,4347,4347,3770,3800,577,547,4216.0,,3910.0,,306.0,,3949,3949,3437,3359,512,590,2412401
1063,18473,17958,17958,13961,14049,3997,3909,17003.0,,13354.0,,3649.0,,16611,16611,13044,12931,3567,3680,2412500
1064,18490,13765,13765,11391,11498,2374,2267,13095.0,,11362.0,,1733.0,,12456,12456,10383,10450,2073,2006,2412609
1065,18511,6031,6031,5077,4929,954,1102,5997.0,,5362.0,,635.0,,5703,5703,5070,4810,633,893,2412708
1066,18538,7262,7262,6022,5873,1240,1389,7019.0,,6290.0,,729.0,,6720,6720,5753,5271,967,1449,2412807
1067,18554,9644,9644,7491,7439,2153,2205,9372.0,,7747.0,,1625.0,,9279,9279,7147,6829,2132,2450,2412906
1068,18570,5117,5117,4211,4251,906,866,5024.0,,4418.0,,606.0,,4832,4832,4097,4029,735,803,2413003
1069,18597,5482,5482,4583,4556,899,926,5254.0,,4751.0,,503.0,,4918,4918,4152,3985,766,933,2413102
1070,18619,3818,3818,3191,3210,627,608,3695.0,,3388.0,,307.0,,3450,3450,3003,2893,447,557,2413201
1071,18635,5558,5558,4503,4443,1055,1115,5287.0,,4683.0,,604.0,,4849,4849,4059,3840,790,1009,2413300
1072,18651,6271,6271,5147,5143,1124,1128,6251.0,,5578.0,,673.0,,5989,5989,5004,4911,985,1078,2413409
1073,18678,6636,6636,5510,5495,1126,1141,6457.0,,5683.0,,774.0,,6170,6170,5252,5020,918,1150,2413508
1074,18694,6669,6669,5597,5542,1072,1127,6482.0,,5880.0,,602.0,,6259,6259,5191,5100,1068,1159,2413607
1075,18716,4952,4952,4028,3933,924,1019,4856.0,,4424.0,,432.0,,4419,4419,3709,3413,710,1006,2413706
1076,18732,2799,2799,2423,2330,376,469,2755.0,,2635.0,,120.0,,2447,2447,2158,2085,289,362,2413805
1077,18759,10159,10159,8578,8401,1581,1758,9818.0,,8615.0,,1203.0,,9715,9715,8369,8110,1346,1605,2413904
1078,18775,12160,12160,9415,9405,2745,2755,11756.0,,9810.0,,1946.0,,11313,11313,8909,8733,2404,2580,2414001
1079,18791,7813,7813,6484,6258,1329,1555,7362.0,,6065.0,,1297.0,,7342,7342,6053,5854,1289,1488,2414100
1080,18813,12528,12528,10307,10344,2221,2184,11598.0,,10191.0,,1407.0,,10397,10397,8744,8641,1653,1756,2414209
1081,18830,2584,2584,2175,2164,409,420,2583.0,,2381.0,,202.0,,2425,2425,1967,1962,458,463,2414308
1082,18856,26028,26028,21451,21052,4577,4976,24785.0,,21283.0,,3502.0,,23394,23394,19378,18722,4016,4672,2414407
1083,18872,8620,8620,7063,7031,1557,1589,8428.0,,7297.0,,1131.0,,8276,8276,6816,6681,1460,1595,2414506
1084,18899,11556,11556,9837,9736,1719,1820,11191.0,,10273.0,,918.0,,10538,10538,9065,8946,1473,1592,2414605
1085,18910,4763,4763,4088,3984,675,779,4616.0,,4234.0,,382.0,,4278,4278,3697,3723,581,555,2414704
1086,18937,3786,3786,3010,2925,776,861,3827.0,,3438.0,,389.0,,3699,3699,2993,2703,706,996,2410603
1087,18953,10440,10440,8362,8518,2078,1922,10086.0,,8548.0,,1538.0,,9709,9709,7942,7980,1767,1729,2414803
1088,18970,1874,1874,1523,1473,351,401,1824.0,,1622.0,,202.0,,1697,1697,1452,1352,245,345,2414902
1089,18996,3102,3102,2530,2485,572,617,2874.0,,2588.0,,286.0,,2653,2653,2239,2184,414,469,2415008
1090,19003,4368,4368,3693,3757,675,611,4267.0,,3816.0,,451.0,,3927,3927,3399,3412,528,515,2512762
1091,19011,7853,7853,6194,6171,1659,1682,7565.0,,6599.0,,966.0,,7024,7024,6029,5954,995,1070,2500106
1092,19020,7248,7248,5968,6084,1280,1164,6738.0,,5826.0,,912.0,,6443,6443,5527,5550,916,893,2515971
1093,19038,4816,4816,3840,3773,976,1043,4736.0,,4149.0,,587.0,,4479,4479,3583,3435,896,1044,2500205
1094,19046,5544,5544,4466,4531,1078,1013,5323.0,,4698.0,,625.0,,4792,4792,3909,3902,883,890,2514453
1095,19054,22125,22125,17317,17459,4808,4666,21480.0,,17556.0,,3924.0,,20641,20641,16908,16795,3733,3846,2500304
1096,19062,6515,6515,5203,5209,1312,1306,6608.0,,5709.0,,899.0,,5598,5598,4588,4507,1010,1091,2504033
1097,19070,16009,16009,12804,13099,3205,2910,15326.0,,12915.0,,2411.0,,14833,14833,11972,12157,2861,2676,2500403
1098,19089,7080,7080,5560,5539,1520,1541,7048.0,,5923.0,,1125.0,,6601,6601,5322,5131,1279,1470,2505238
1099,19097,11590,11590,9319,9433,2271,2157,11325.0,,9678.0,,1647.0,,10676,10676,8853,8762,1823,1914,2500502
1100,19100,5738,5738,4634,4560,1104,1178,5682.0,,4971.0,,711.0,,4896,4896,4050,3915,846,981,2505279
1101,19119,18773,18773,15612,15905,3161,2868,17736.0,,15523.0,,2213.0,,16889,16889,14312,14622,2577,2267,2500601
1102,19127,4478,4478,3755,3757,723,721,4259.0,,3792.0,,467.0,,3955,3955,3415,3322,540,633,2512754
1103,19135,13927,13927,11699,11718,2228,2209,13477.0,,11602.0,,1875.0,,13140,13140,11344,11323,1796,1817,2500700
1104,19143,4508,4508,3588,3651,920,857,4457.0,,3857.0,,600.0,,4087,4087,3266,3296,821,791,2509339
1105,19151,13966,13966,11161,11255,2805,2711,13619.0,,11492.0,,2127.0,,13094,13094,10514,10477,2580,2617,2500809
1106,19160,4001,4001,3363,3329,638,672,3919.0,,3560.0,,359.0,,3381,3381,2842,2745,539,636,2508554
1107,19178,8910,8910,6851,6931,2059,1979,8608.0,,6799.0,,1809.0,,8362,8362,6768,6766,1594,1596,2500908
1108,19186,4350,4350,3552,3593,798,757,4157.0,,3670.0,,487.0,,3959,3959,3317,3346,642,613,2515930
1109,19194,13681,13681,10397,10662,3284,3019,13127.0,,11181.0,,1946.0,,12191,12191,9717,9730,2474,2461,2501005
1110,19208,3204,3204,2496,2570,708,634,3181.0,,2901.0,,280.0,,3023,3023,2498,2397,525,626,2512747
1111,19216,18462,18462,14841,15014,3621,3448,17947.0,,14727.0,,3220.0,,17753,17753,14942,14719,2811,3034,2501104
1112,19224,3039,3039,2430,2416,609,623,3044.0,,2792.0,,252.0,,2793,2793,2218,2038,575,755,2513943
1113,19232,6073,6073,4960,5065,1113,1008,5754.0,,4873.0,,881.0,,5534,5534,4653,4655,881,879,2501203
1114,19240,4162,4162,3589,3602,573,560,4111.0,,3744.0,,367.0,,3927,3927,3345,3246,582,681,2504074
1115,19259,15692,15692,12875,13051,2817,2641,15149.0,,13128.0,,2021.0,,14473,14473,12354,12407,2119,2066,2501302
1116,19267,2946,2946,2366,2374,580,572,2859.0,,2513.0,,346.0,,2650,2650,2121,1994,529,656,2513851
1117,19275,4555,4555,3511,3617,1044,938,4450.0,,3845.0,,605.0,,4082,4082,3356,3357,726,725,2505352
1118,19283,3332,3332,2767,2794,565,538,3206.0,,2953.0,,253.0,,2913,2913,2512,2434,401,479,2516151
1119,19291,7364,7364,6132,6139,1232,1225,7074.0,,6412.0,,662.0,,6194,6194,5433,5245,761,949,2501401
1120,19305,4474,4474,3622,3650,852,824,4254.0,,3764.0,,490.0,,3976,3976,3328,3235,648,741,2501534
1121,19313,18101,18101,14370,14610,3731,3491,17139.0,,14100.0,,3039.0,,16761,16761,13646,13632,3115,3129,2501500
1122,19321,4143,4143,3320,3242,823,901,3865.0,,3403.0,,462.0,,3610,3610,2841,2731,769,879,2501351
1123,19330,10682,10682,8678,8802,2004,1880,10397.0,,9073.0,,1324.0,,9997,9997,8281,8288,1716,1709,2501609
1124,19348,2388,2388,1933,1889,455,499,2320.0,,2112.0,,208.0,,2034,2034,1676,1615,358,419,2517407
1125,19356,5679,5679,4928,4937,751,742,5452.0,,5001.0,,451.0,,4832,4832,4149,4042,683,790,2501708
1126,19364,6279,6279,4660,4627,1619,1652,5968.0,,5205.0,,763.0,,5516,5516,4405,4325,1111,1191,2503555
1127,19372,73291,73291,62783,63207,10508,10084,71288.0,,61109.0,,10179.0,,69692,69692,60998,60968,8694,8724,2501807
1128,19380,3863,3863,3087,3056,776,807,3733.0,,3331.0,,402.0,,3429,3429,2819,2683,610,746,2503753
1129,19399,13097,13097,10329,10552,2768,2545,12899.0,,10929.0,,1970.0,,12712,12712,10262,10521,2450,2191,2501906
1130,19402,3804,3804,3021,3001,783,803,3673.0,,3271.0,,402.0,,3490,3490,2872,2687,618,803,2513927
1131,19410,6322,6322,5071,4919,1251,1403,6209.0,,5631.0,,578.0,,5484,5484,4540,4122,944,1362,2502003
1132,19429,3213,3213,2591,2578,622,635,3080.0,,2741.0,,339.0,,2861,2861,2326,2229,535,632,2513968
1133,19437,5331,5331,4069,3989,1262,1342,5298.0,,4542.0,,756.0,,5006,5006,3991,3719,1015,1287,2502102
1134,19445,3214,3214,2631,2636,583,578,3125.0,,2732.0,,393.0,,3081,3081,2588,2500,493,581,2514552
1135,19453,3051,3051,2513,2533,538,518,2980.0,,2692.0,,288.0,,2793,2793,2306,2281,487,512,2502201
1136,19461,6106,6106,5166,5160,940,946,5916.0,,5316.0,,600.0,,5373,5373,4683,4552,690,821,2509156
1137,19470,4528,4528,3794,3744,734,784,4323.0,,3784.0,,539.0,,4106,4106,3518,3377,588,729,2502300
1138,19488,3241,3241,2362,2304,879,937,3078.0,,2900.0,,178.0,,2576,2576,1960,1852,616,724,2509370
1139,19496,7578,7578,6014,6033,1564,1545,7439.0,,6210.0,,1229.0,,7112,7112,5809,5735,1303,1377,2502409
1140,19500,3166,3166,2448,2434,718,732,2963.0,,2692.0,,271.0,,2518,2518,2120,2130,398,388,2502052
1141,19518,15043,15043,12402,12502,2641,2541,14321.0,,12524.0,,1797.0,,13737,13737,11529,11513,2208,2224,2502508
1142,19526,3916,3916,3208,3216,708,700,3837.0,,3426.0,,411.0,,3714,3714,3144,3128,570,586,2512077
1143,19534,5755,5755,4330,4192,1425,1563,5710.0,,4886.0,,824.0,,5359,5359,4239,3954,1120,1405,2502607
1144,19542,2200,2200,1889,1840,311,360,2032.0,,1885.0,,147.0,,1824,1824,1601,1436,223,388,2514651
1145,19550,4549,4549,3571,3579,978,970,4516.0,,3899.0,,617.0,,4227,4227,3419,3319,808,908,2502706
1146,19569,3818,3818,3022,2995,796,823,3702.0,,3314.0,,388.0,,3300,3300,2720,2584,580,716,2513356
1147,19577,10302,10302,8400,8321,1902,1981,9863.0,,8821.0,,1042.0,,9400,9400,7776,7324,1624,2076,2502805
1148,19585,2587,2587,2116,2096,471,491,2592.0,,2389.0,,203.0,,2274,2274,1949,1854,325,420,2500734
1149,19593,5814,5814,4909,4821,905,993,5699.0,,5160.0,,539.0,,5402,5402,4556,4464,846,938,2502904
1150,19607,6014,6014,4671,4688,1343,1326,5848.0,,4838.0,,1010.0,,5384,5384,4408,4377,976,1007,2504157
1151,19615,16346,16346,13753,13807,2593,2539,16126.0,,14311.0,,1815.0,,15160,15160,13356,13438,1804,1722,2503001
1152,19623,7506,7506,6228,6192,1278,1314,7102.0,,6225.0,,877.0,,6731,6731,5922,5857,809,874,2506251
1153,19631,4882,4882,4188,4247,694,635,4734.0,,4230.0,,504.0,,4469,4469,3802,3640,667,829,2503100
1154,19640,4062,4062,3091,3117,971,945,3859.0,,3373.0,,486.0,,3293,3293,2768,2716,525,577,2512036
1155,19658,51041,51041,40952,41176,10089,9865,48731.0,,36856.0,,11875.0,,46699,46699,37959,37476,8740,9223,2503209
1156,19666,2557,2557,1994,1992,563,565,2603.0,,2278.0,,325.0,,2509,2509,2089,2033,420,476,2513653
1157,19674,7744,7744,6207,6179,1537,1565,7499.0,,6370.0,,1129.0,,7295,7295,6073,5962,1222,1333,2503308
1158,19682,2890,2890,2452,2390,438,500,2763.0,,2460.0,,303.0,,2588,2588,2148,2082,440,506,2516755
1159,19690,3952,3952,3219,3222,733,730,3697.0,,3302.0,,395.0,,3426,3426,2907,2807,519,619,2503407
1160,19704,1901,1901,1601,1619,300,282,1829.0,,1698.0,,131.0,,1756,1756,1460,1435,296,321,2504850
1161,19712,13857,13857,10644,10865,3213,2992,13510.0,,11535.0,,1975.0,,12412,12412,10107,10147,2305,2265,2503506
1162,19720,2163,2163,1804,1800,359,363,2176.0,,1936.0,,240.0,,2114,2114,1759,1603,355,511,2510659
1163,19739,6253,6253,4894,4917,1359,1336,6080.0,,5218.0,,862.0,,6107,6107,4871,4534,1236,1573,2503605
1164,19747,5435,5435,4012,4125,1423,1310,5317.0,,4500.0,,817.0,,4644,4644,3596,3409,1048,1235,2512721
1165,19755,45912,45912,38305,38100,7607,7812,44421.0,,36462.0,,7959.0,,43650,43650,37451,36938,6199,6712,2503704
1166,19763,4667,4667,4073,4093,594,574,4476.0,,4195.0,,281.0,,4236,4236,3713,3640,523,596,2500536
1167,19771,5282,5282,4413,4398,869,884,5114.0,,4437.0,,677.0,,4877,4877,4124,4105,753,772,2503803
1168,19780,7428,7428,6153,6190,1275,1238,7220.0,,6311.0,,909.0,,7036,7036,6026,5922,1010,1114,2501575
1169,19798,5985,5985,4916,5058,1069,927,5870.0,,5280.0,,590.0,,5320,5320,4460,4407,860,913,2503902
1170,19801,4944,4944,4256,4296,688,648,4688.0,,4292.0,,396.0,,4438,4438,3909,3922,529,516,2504355
1171,19810,296494,296494,256378,258075,40116,38419,285020.0,,235263.0,,49757.0,,285487,285487,250389,249507,35098,35980,2504009
1172,19828,2404,2404,2083,2052,321,352,2315.0,,2174.0,,141.0,,2090,2090,1830,1743,260,347,2512788
1173,19836,2302,2302,1814,1678,488,624,2302.0,,2134.0,,168.0,,2017,2017,1667,1527,350,490,2504108
1174,19844,6858,6858,5773,5788,1085,1070,6532.0,,5735.0,,797.0,,6469,6469,5415,5426,1054,1043,2500775
1175,19852,5314,5314,4051,3956,1263,1358,5168.0,,4592.0,,576.0,,4527,4527,3522,3301,1005,1226,2504207
1176,19860,4007,4007,3451,3467,556,540,3981.0,,3650.0,,331.0,,3683,3683,3187,3065,496,618,2513984
1177,19879,21374,21374,18007,17901,3367,3473,20346.0,,16958.0,,3388.0,,19951,19951,17193,16877,2758,3074,2504306
1178,19887,5014,5014,4079,4058,935,956,4876.0,,4156.0,,720.0,,4802,4802,3832,3749,970,1053,2517209
1179,19895,14502,14502,11607,11494,2895,3008,13911.0,,11998.0,,1913.0,,13180,13180,11193,10879,1987,2301,2504405
1180,19909,2156,2156,1789,1727,367,429,2106.0,,1962.0,,144.0,,1886,1886,1614,1495,272,391,2501153
1181,19917,5548,5548,4513,4479,1035,1069,5372.0,,4571.0,,801.0,,5140,5140,4379,4264,761,876,2504504
1182,19925,2993,2993,2429,2436,564,557,2915.0,,2583.0,,332.0,,2798,2798,2365,2307,433,491,2500577
1183,19933,22651,22651,18785,19191,3866,3460,20823.0,,18156.0,,2667.0,,18326,18326,16164,16281,2162,2045,2504603
1184,19941,5924,5924,5232,5218,692,706,5921.0,,5272.0,,649.0,,5615,5615,4907,4828,708,787,2502151
1185,19950,5101,5101,4412,4344,689,757,4972.0,,4500.0,,472.0,,4671,4671,4051,3889,620,782,2504702
1186,19968,6957,6957,5824,5858,1133,1099,6476.0,,5795.0,,681.0,,6012,6012,5122,5130,890,882,2509057
1187,19976,12185,12185,9403,9506,2782,2679,11738.0,,9718.0,,2020.0,,11342,11342,9243,8928,2099,2414,2504801
1188,19984,5510,5510,4339,4343,1171,1167,5364.0,,4419.0,,945.0,,5100,5100,4109,4097,991,1003,2509396
1189,19992,15913,15913,13510,13629,2403,2284,15427.0,,13927.0,,1500.0,,14338,14338,12853,12756,1485,1582,2504900
1190,20001,6643,6643,5813,5896,830,747,6185.0,,5736.0,,449.0,,5680,5680,5050,4987,630,693,2513158
1191,20010,6498,6498,5342,5386,1156,1112,6269.0,,5525.0,,744.0,,6069,6069,5125,4975,944,1094,2505006
1192,20036,16959,16959,13556,13691,3403,3268,16338.0,,13957.0,,2381.0,,15606,15606,13321,12893,2285,2713,2505105
1193,20052,5805,5805,4513,4643,1292,1162,5781.0,,4892.0,,889.0,,5493,5493,4350,4425,1143,1068,2505204
1194,20079,2356,2356,1839,1832,517,524,2281.0,,1979.0,,302.0,,2244,2244,1825,1690,419,554,2505303
1195,20095,7388,7388,5878,5827,1510,1561,7098.0,,6304.0,,794.0,,6594,6594,5372,5219,1222,1375,2505402
1196,20117,3257,3257,2503,2466,754,791,3069.0,,2463.0,,606.0,,2878,2878,2202,2079,676,799,2505501
1197,20133,5632,5632,4221,4146,1411,1486,5601.0,,4671.0,,930.0,,5321,5321,4087,3969,1234,1352,2505600
1198,20150,9065,9065,7151,7202,1914,1863,8730.0,,7409.0,,1321.0,,8317,8317,6739,6591,1578,1726,2505709
1199,20176,3564,3564,2927,2881,637,683,3494.0,,3071.0,,423.0,,3229,3229,2773,2647,456,582,2505808
1200,20192,3351,3351,2624,2604,727,747,3283.0,,2957.0,,326.0,,3035,3035,2355,2206,680,829,2505907
1201,20214,24953,24953,20348,20770,4605,4183,24253.0,,20578.0,,3675.0,,23698,23698,19654,19847,4044,3851,2506004
1202,20230,10068,10068,7968,8119,2100,1949,9597.0,,8025.0,,1572.0,,9039,9039,7658,7696,1381,1343,2506103
1203,20257,2820,2820,2367,2338,453,482,2745.0,,2478.0,,267.0,,2591,2591,2260,2090,331,501,2506202
1204,20273,42663,42663,35621,35846,7042,6817,41065.0,,34302.0,,6763.0,,40210,40210,34003,33893,6207,6317,2506301
1205,20290,11247,11247,9153,9221,2094,2026,11141.0,,9576.0,,1565.0,,10750,10750,8928,8862,1822,1888,2506400
1206,20311,3121,3121,2636,2633,485,488,3087.0,,2740.0,,347.0,,2961,2961,2463,2358,498,603,2506509
1207,20338,5522,5522,4281,4196,1241,1326,5491.0,,4896.0,,595.0,,5002,5002,4206,3973,796,1029,2506608
1208,20354,8807,8807,6619,6693,2188,2114,8655.0,,7186.0,,1469.0,,8192,8192,6643,6524,1549,1668,2506707
1209,20370,14821,14821,11924,12054,2897,2767,14353.0,,12337.0,,2016.0,,13316,13316,11457,11284,1859,2032,2506806
1210,20397,18985,18985,15761,15932,3224,3053,18392.0,,15723.0,,2669.0,,18074,18074,15568,15353,2506,2721,2506905
1211,20419,17143,17143,13456,13455,3687,3688,16715.0,,13785.0,,2930.0,,16386,16386,13219,12891,3167,3495,2507002
1212,20435,13206,13206,10903,11001,2303,2205,12902.0,,11008.0,,1894.0,,12202,12202,10196,10188,2006,2014,2507101
1213,20451,8456,8456,6970,7005,1486,1451,8158.0,,7124.0,,1034.0,,7786,7786,6777,6686,1009,1100,2507200
1214,20478,13814,13814,10587,10722,3227,3092,13408.0,,11124.0,,2284.0,,12872,12872,9992,9810,2880,3062,2507309
1215,20494,6893,6893,5477,5493,1416,1400,6668.0,,6090.0,,578.0,,6098,6098,4991,4986,1107,1112,2507408
1216,20516,559205,559205,474496,481036,84709,78169,522269.0,522269.0,411149.0,400352.0,111120.0,121917.0,517607,517607,451769,449690,65838,67917,2507507
1217,20532,7405,7405,6149,6187,1256,1218,7155.0,,6431.0,,724.0,,6487,6487,5629,5461,858,1026,2507606
1218,20559,13293,13293,10720,10699,2573,2594,13008.0,,10818.0,,2190.0,,12533,12533,10148,9821,2385,2712,2507705
1219,20575,5683,5683,4729,4674,954,1009,5409.0,,4782.0,,627.0,,5120,5120,4148,4044,972,1076,2507804
1220,20591,9745,9745,8145,8257,1600,1488,9175.0,,8142.0,,1033.0,,8855,8855,7815,7756,1040,1099,2507903
1221,20613,7732,7732,6028,6059,1704,1673,7456.0,,6283.0,,1173.0,,7039,7039,5878,5809,1161,1230,2508000
1222,20630,4779,4779,3755,3614,1024,1165,4742.0,,4095.0,,647.0,,4431,4431,3548,3413,883,1018,2508109
1223,20656,7230,7230,5591,5637,1639,1593,7119.0,,6135.0,,984.0,,6241,6241,4827,4868,1414,1373,2508208
1224,20672,20643,20643,17619,17778,3024,2865,19729.0,,16957.0,,2772.0,,19214,19214,16525,16700,2689,2514,2508307
1225,20699,4243,4243,3513,3475,730,768,4249.0,,3967.0,,282.0,,3605,3605,3038,2831,567,774,2508406
1226,20710,5840,5840,4598,4612,1242,1228,5790.0,,4848.0,,942.0,,5567,5567,4493,4398,1074,1169,2508505
1227,20737,12426,12426,10064,9878,2362,2548,12095.0,,10362.0,,1733.0,,11135,11135,9167,8831,1968,2304,2508604
1228,20753,3772,3772,3078,3092,694,680,3838.0,,3407.0,,431.0,,3706,3706,2978,2815,728,891,2508703
1229,20770,5181,5181,4114,4105,1067,1076,5046.0,,4361.0,,685.0,,4592,4592,3820,3792,772,800,2508802
1230,20796,32590,32590,26830,27000,5760,5590,30923.0,,25634.0,,5289.0,,30876,30876,25615,25386,5261,5490,2508901
1231,20818,8662,8662,6752,6894,1910,1768,8323.0,,7263.0,,1060.0,,7686,7686,6276,6297,1410,1389,2509008
1232,20834,17162,17162,14592,14640,2570,2522,16375.0,,14348.0,,2027.0,,15235,15235,13570,13510,1665,1725,2509107
1233,20850,11720,11720,9736,9809,1984,1911,11458.0,,9844.0,,1614.0,,10784,10784,9047,9158,1737,1626,2509206
1234,20877,8491,8491,6548,6467,1943,2024,8586.0,,7428.0,,1158.0,,7332,7332,5969,5693,1363,1639,2509305
1235,20893,10679,10679,8759,8826,1920,1853,10240.0,,8816.0,,1424.0,,10042,10042,8748,8708,1294,1334,2509404
1236,20915,4863,4863,4112,4195,751,668,4712.0,,4207.0,,505.0,,4294,4294,3684,3740,610,554,2509503
1237,20931,3994,3994,3046,3053,948,941,3875.0,,3218.0,,657.0,,3637,3637,2857,2880,780,757,2509602
1238,20958,25791,25791,21217,21301,4574,4490,24515.0,,21032.0,,3483.0,,23932,23932,19963,19728,3969,4204,2509701
1239,20974,8907,8907,7495,7426,1412,1481,8625.0,,7638.0,,987.0,,8152,8152,7198,6857,954,1295,2509800
1240,20990,6591,6591,5355,5424,1236,1167,6310.0,,5519.0,,791.0,,5699,5699,4993,4871,706,828,2509909
1241,21016,6840,6840,5722,5750,1118,1090,6582.0,,6062.0,,520.0,,6065,6065,5213,5107,852,958,2510006
1242,21032,8000,8000,6298,6417,1702,1583,7684.0,,6474.0,,1210.0,,7471,7471,6218,6223,1253,1248,2510105
1243,21059,5553,5553,3948,3946,1605,1607,5570.0,,4521.0,,1049.0,,4981,4981,3734,3670,1247,1311,2510204
1244,21075,3382,3382,2934,2979,448,403,3307.0,,3075.0,,232.0,,3107,3107,2778,2699,329,408,2510303
1245,21091,6999,6999,5340,5446,1659,1553,6857.0,,5871.0,,986.0,,6657,6657,5174,4813,1483,1844,2510402
1246,21113,3949,3949,3288,3285,661,664,3908.0,,3568.0,,340.0,,3555,3555,3016,2925,539,630,2510501
1247,21130,2909,2909,2500,2488,409,421,2726.0,,2474.0,,252.0,,2600,2600,2267,2174,333,426,2510600
1248,21156,2652,2652,2086,2074,566,578,2562.0,,2371.0,,191.0,,2305,2305,1930,1828,375,477,2510709
1249,21172,66980,66980,55275,55371,11705,11609,63933.0,,53164.0,,10769.0,,63697,63697,54326,53363,9371,10334,2510808
1250,21199,9910,9910,8154,8144,1756,1766,9696.0,,8479.0,,1217.0,,9520,9520,7763,7471,1757,2049,2510907
1251,21210,3942,3942,3006,2992,936,950,3858.0,,3309.0,,549.0,,3752,3752,2878,2789,874,963,2511004
1252,21237,5951,5951,5057,5083,894,868,5798.0,,5305.0,,493.0,,5558,5558,4959,4778,599,780,2511103
1253,21253,23716,23716,19379,19740,4337,3976,22796.0,,19658.0,,3138.0,,21941,21941,18242,18159,3699,3782,2511202
1254,21270,12715,12715,10055,10166,2660,2549,12524.0,,10256.0,,2268.0,,12272,12272,9856,9442,2416,2830,2511301
1255,21296,14788,14788,12295,12455,2493,2333,14475.0,,12852.0,,1623.0,,13831,13831,11920,11652,1911,2179,2511400
1256,21318,9889,9889,8377,8416,1512,1473,9612.0,,8321.0,,1291.0,,9189,9189,8032,7928,1157,1261,2511509
1257,21334,6943,6943,5422,5462,1521,1481,6728.0,,5680.0,,1048.0,,6562,6562,5201,5118,1361,1444,2511608
1258,21350,5264,5264,4249,4367,1015,897,5012.0,,4451.0,,561.0,,4862,4862,3903,3997,959,865,2511707
1259,21377,7701,7701,6187,6301,1514,1400,7450.0,,6291.0,,1159.0,,7177,7177,5923,5883,1254,1294,2511806
1260,21393,12043,12043,9886,9890,2157,2153,11401.0,,10016.0,,1385.0,,10490,10490,9049,9072,1441,1418,2511905
1261,21415,14055,14055,11553,11825,2502,2230,13491.0,,11809.0,,1682.0,,12991,12991,11078,11013,1913,1978,2512002
1262,21431,25164,25164,20239,20230,4925,4934,24669.0,,20558.0,,4111.0,,24276,24276,19979,19307,4297,4969,2512101
1263,21458,4037,4037,3355,3299,682,738,4002.0,,3680.0,,322.0,,3587,3587,3084,2952,503,635,2512200
1264,21474,16137,16137,12626,12899,3511,3238,15398.0,,12597.0,,2801.0,,14839,14839,12243,11985,2596,2854,2512309
1265,21490,12016,12016,10293,10493,1723,1523,11373.0,,10026.0,,1347.0,,10986,10986,9745,9766,1241,1220,2512408
1266,21512,34745,34745,29084,29527,5661,5218,33190.0,,28419.0,,4771.0,,31884,31884,27587,27595,4297,4289,2512507
1267,21539,2288,2288,1964,1926,324,362,2153.0,,2036.0,,117.0,,1970,1970,1683,1625,287,345,2512606
1268,21555,14207,14207,11356,11510,2851,2697,13655.0,,11275.0,,2380.0,,13317,13317,10875,10915,2442,2402,2512705
1269,21571,7637,7637,6535,6483,1102,1154,7479.0,,6866.0,,613.0,,7252,7252,6363,6151,889,1101,2512804
1270,21598,18201,18201,15713,15805,2488,2396,17322.0,,15372.0,,1950.0,,16827,16827,14801,14835,2026,1992,2512903
1271,21610,3283,3283,2565,2421,718,862,3284.0,,3029.0,,255.0,,3034,3034,2425,2142,609,892,2513000
1272,21636,9680,9680,7812,7838,1868,1842,9382.0,,8167.0,,1215.0,,8975,8975,7587,7419,1388,1556,2513109
1273,21652,5589,5589,4632,4660,957,929,5519.0,,5027.0,,492.0,,5303,5303,4443,4343,860,960,2513208
1274,21679,5589,5589,4606,4718,983,871,5539.0,,4934.0,,605.0,,5147,5147,4321,4324,826,823,2513307
1275,21695,11819,11819,10013,9936,1806,1883,11378.0,,9938.0,,1440.0,,11153,11153,9288,9005,1865,2148,2513406
1276,21717,4463,4463,3517,3476,946,987,4383.0,,3924.0,,459.0,,4120,4120,3403,3282,717,838,2513505
1277,21733,6282,6282,4760,4719,1522,1563,6137.0,,5130.0,,1007.0,,6019,6019,4626,4444,1393,1575,2513604
1278,21750,98394,98394,82697,83265,15697,15129,94595.0,,79988.0,,14607.0,,92936,92936,80278,80380,12658,12556,2513703
1279,21776,5568,5568,4584,4653,984,915,5385.0,,4805.0,,580.0,,4954,4954,4132,3980,822,974,2513802
1280,21792,27046,27046,22647,21970,4399,5076,25855.0,,23449.0,,2406.0,,24607,24607,21203,19352,3404,5255,2513901
1281,21814,4211,4211,3511,3464,700,747,4250.0,,3715.0,,535.0,,4035,4035,3271,3120,764,915,2514008
1282,21830,3874,3874,3217,3253,657,621,3766.0,,3405.0,,361.0,,3646,3646,3061,2902,585,744,2514107
1283,21857,6603,6603,5441,5498,1162,1105,6439.0,,5568.0,,871.0,,6229,6229,5188,5089,1041,1140,2514206
1284,21873,5340,5340,3949,3951,1391,1389,5107.0,,4372.0,,735.0,,4743,4743,3549,3452,1194,1291,2514305
1285,21890,4340,4340,3537,3519,803,821,4150.0,,3583.0,,567.0,,3998,3998,3445,3272,553,726,2514404
1286,21911,15138,15138,12262,12230,2876,2908,14633.0,,12274.0,,2359.0,,14291,14291,11814,11587,2477,2704,2514503
1287,21938,4041,4041,3362,3352,679,689,3780.0,,3305.0,,475.0,,3472,3472,2903,2864,569,608,2514602
1288,21954,4074,4074,3677,3628,397,446,3903.0,,3514.0,,389.0,,3805,3805,3380,3239,425,566,2514701
1289,21970,3464,3464,2784,2794,680,670,3304.0,,2831.0,,473.0,,3148,3148,2545,2521,603,627,2514800
1290,21997,7019,7019,5586,5597,1433,1422,6640.0,,5781.0,,859.0,,6393,6393,5010,4839,1383,1554,2514909
1291,22012,6090,6090,5082,5212,1008,878,5958.0,,5405.0,,553.0,,5507,5507,4780,4771,727,736,2515005
1292,22039,8779,8779,6966,7178,1813,1601,8534.0,,7030.0,,1504.0,,8445,8445,6907,7042,1538,1403,2515104
1293,22055,3135,3135,2570,2573,565,562,3077.0,,2695.0,,382.0,,2977,2977,2534,2486,443,491,2515203
1294,22071,36143,36143,30204,30288,5939,5855,34693.0,,29458.0,,5235.0,,33886,33886,29575,29307,4311,4579,2515302
1295,22098,8956,8956,7062,7170,1894,1786,8738.0,,7478.0,,1260.0,,8370,8370,6834,6670,1536,1700,2515401
1296,22110,10432,10432,8439,8516,1993,1916,10055.0,,8499.0,,1556.0,,9877,9877,7970,7793,1907,2084,2515500
1297,22136,3036,3036,2455,2407,581,629,2917.0,,2613.0,,304.0,,2604,2604,2175,1978,429,626,2515609
1298,22152,3204,3204,2464,2433,740,771,3196.0,,2697.0,,499.0,,3125,3125,2426,2295,699,830,2515708
1299,22179,6178,6178,5200,5195,978,983,6056.0,,5336.0,,720.0,,5921,5921,5145,5108,776,813,2515807
1300,22195,4389,4389,3370,3380,1019,1009,4304.0,,3584.0,,720.0,,4163,4163,3403,3371,760,792,2515906
1301,22217,21395,21395,16929,17227,4466,4168,20600.0,,16966.0,,3634.0,,19758,19758,16364,16289,3394,3469,2516003
1302,22233,11177,11177,9206,9318,1971,1859,10876.0,,9285.0,,1591.0,,10625,10625,8828,8686,1797,1939,2516102
1303,22250,46662,46662,39549,39723,7113,6939,45115.0,,37995.0,,7120.0,,44885,44885,38802,38084,6083,6801,2516201
1304,22276,13552,13552,11104,11093,2448,2459,12965.0,,10774.0,,2191.0,,12667,12667,10315,10232,2352,2435,2516300
1305,22292,7476,7476,5981,6046,1495,1430,7288.0,,6602.0,,686.0,,6501,6501,5432,5296,1069,1205,2516409
1306,22314,11031,11031,8429,8552,2602,2479,10756.0,,8792.0,,1964.0,,10550,10550,8277,8139,2273,2411,2516508
1307,22330,11555,11555,8631,8714,2924,2841,11172.0,,9007.0,,2165.0,,10538,10538,8552,8388,1986,2150,2516607
1308,22357,11698,11698,9469,9519,2229,2179,11353.0,,9745.0,,1608.0,,10757,10757,8885,8736,1872,2021,2516706
1309,22373,7420,7420,5887,5895,1533,1525,7236.0,,6338.0,,898.0,,6469,6469,5276,5293,1193,1176,2516805
1310,22390,12006,12006,10034,9940,1972,2066,11284.0,,10136.0,,1148.0,,10511,10511,9083,8812,1428,1699,2516904
1311,22411,6829,6829,5526,5611,1303,1218,6497.0,,5685.0,,812.0,,6038,6038,5226,5223,812,815,2517001
1312,22438,2575,2575,2240,2211,335,364,2537.0,,2336.0,,201.0,,2418,2418,2073,2001,345,417,2517100
1313,23000,6117,6117,4969,5025,1148,1092,5948.0,,5039.0,,909.0,,5705,5705,4693,4679,1012,1026,2611533
1314,23019,28558,28558,22506,22860,6052,5698,27557.0,,21312.0,,6245.0,,27303,27303,20590,20857,6713,6446,2600104
1315,23027,14340,14340,12394,12622,1946,1718,13561.0,,12371.0,,1190.0,,12536,12536,11165,11130,1371,1406,2608453
1316,23035,17280,17280,13816,13918,3464,3362,16872.0,,14779.0,,2093.0,,16055,16055,12899,12027,3156,4028,2600203
1317,23043,9157,9157,7560,7733,1597,1424,8915.0,,7846.0,,1069.0,,8428,8428,7121,7387,1307,1041,2612471
1318,23051,19673,19673,16474,16736,3199,2937,18940.0,,16460.0,,2480.0,,18041,18041,14996,15415,3045,2626,2600302
1319,23060,10460,10460,7812,7782,2648,2678,10238.0,,8549.0,,1689.0,,9402,9402,7541,7444,1861,1958,2616506
1320,23078,23319,23319,15730,15766,7589,7553,23550.0,,17500.0,,6050.0,,23368,23368,15617,14902,7751,8466,2600401
1321,23086,7751,7751,6300,6336,1451,1415,7555.0,,6552.0,,1003.0,,7242,7242,6051,5958,1191,1284,2616183
1322,23094,33251,33251,24139,24309,9112,8942,31873.0,,24348.0,,7525.0,,31755,31755,22851,22816,8904,8939,2600500
1323,23108,12412,12412,10140,10238,2272,2174,11961.0,,10141.0,,1820.0,,11132,11132,8706,8181,2426,2951,2612455
1324,23116,12721,12721,9959,10065,2762,2656,12476.0,,9940.0,,2536.0,,12129,12129,9215,9225,2914,2904,2600609
1325,23124,9806,9806,8000,8133,1806,1673,9587.0,,8457.0,,1130.0,,8803,8803,7046,7251,1757,1552,2608255
1326,23132,28735,28735,22124,22502,6611,6233,27853.0,,22056.0,,5797.0,,27330,27330,21004,21694,6326,5636,2600708
1327,23140,16349,16349,12950,13272,3399,3077,16085.0,,13924.0,,2161.0,,15509,15509,11941,11719,3568,3790,2605152
1328,23159,16690,16690,13852,14007,2838,2683,16198.0,,13746.0,,2452.0,,16016,16016,13141,13133,2875,2883,2600807
1329,23167,12200,12200,9118,9127,3082,3073,12064.0,,10055.0,,2009.0,,11087,11087,8058,8038,3029,3049,2603926
1330,23175,16894,16894,13551,13646,3343,3248,16281.0,,13824.0,,2457.0,,15937,15937,12967,12681,2970,3256,2600906
1331,23183,21229,21229,16114,16282,5115,4947,21107.0,,16637.0,,4470.0,,19174,19174,14686,14147,4488,5027,2608750
1332,23191,9384,9384,6957,7161,2427,2223,9407.0,,7602.0,,1805.0,,8865,8865,6590,6553,2275,2312,2601003
1333,23205,16155,16155,13849,13955,2306,2200,15421.0,,13694.0,,1727.0,,14706,14706,12813,12749,1893,1957,2601052
1334,23213,58765,58765,46271,47119,12494,11646,56296.0,,45923.0,,10373.0,,55401,55401,43408,43335,11993,12066,2601102
1335,23221,11761,11761,9314,9422,2447,2339,11531.0,,9824.0,,1707.0,,11160,11160,9201,9148,1959,2012,2604155
1336,23230,49020,49020,40388,40543,8632,8477,47201.0,,39205.0,,7996.0,,45956,45956,37748,37499,8208,8457,2601201
1337,23248,13356,13356,9607,9662,3749,3694,12782.0,,9797.0,,2985.0,,12635,12635,9088,9301,3547,3334,2609154
1338,23256,9832,9832,8367,8237,1465,1595,9466.0,,8647.0,,819.0,,8950,8950,7909,7515,1041,1435,2601300
1339,23264,10789,10789,8361,8401,2428,2388,10337.0,,8609.0,,1728.0,,9826,9826,7995,8005,1831,1821,2608057
1340,23272,30897,30897,23555,23745,7342,7152,30355.0,,23806.0,,6549.0,,30112,30112,22895,22683,7217,7429,2601409
1341,23280,18267,18267,14655,14857,3612,3410,17103.0,,14442.0,,2661.0,,16386,16386,12941,12873,3445,3513,2614857
1342,23299,9661,9661,7646,7565,2015,2096,9804.0,,8281.0,,1523.0,,9070,9070,7077,6740,1993,2330,2601508
1343,23302,9965,9965,7043,7090,2922,2875,9975.0,,7854.0,,2121.0,,9600,9600,6413,6236,3187,3364,2607950
1344,23310,15150,15150,12220,12087,2930,3063,14725.0,,12580.0,,2145.0,,14498,14498,12156,11818,2342,2680,2601607
1345,23329,12458,12458,9530,9625,2928,2833,12184.0,,10310.0,,1874.0,,11370,11370,8490,8067,2880,3303,2612554
1346,23337,62321,62321,48957,49516,13364,12805,62104.0,,49227.0,,12877.0,,60167,60167,44516,44589,15651,15578,2601706
1347,23353,10511,10511,7452,7308,3059,3203,10312.0,,8064.0,,2248.0,,10083,10083,7057,6595,3026,3488,2601805
1348,23370,46509,46509,39279,39823,7230,6686,44797.0,,37751.0,,7046.0,,43668,43668,36484,36959,7184,6709,2601904
1349,23396,25376,25376,20673,21166,4703,4210,23965.0,,21279.0,,2686.0,,21992,21992,18936,19094,3056,2898,2602001
1350,23418,37539,37539,26228,26394,11311,11145,36977.0,,26815.0,,10162.0,,35609,35609,24633,24448,10976,11161,2602100
1351,23434,29850,29850,23979,24165,5871,5685,28916.0,,24230.0,,4686.0,,27995,27995,22840,22637,5155,5358,2602209
1352,23450,30420,30420,24525,24909,5895,5511,29328.0,,24081.0,,5247.0,,29040,29040,23364,23517,5676,5523,2602308
1353,23477,9054,9054,7393,7515,1661,1539,8848.0,,7256.0,,1592.0,,8752,8752,7275,7420,1477,1332,2602407
1354,23493,7841,7841,5773,5916,2068,1925,7722.0,,6389.0,,1333.0,,7153,7153,5290,5232,1863,1921,2602506
1355,23515,33631,33631,26450,26855,7181,6776,32492.0,,26054.0,,6438.0,,31848,31848,23810,23911,8038,7937,2602605
1356,23531,11293,11293,9303,9392,1990,1901,10951.0,,9895.0,,1056.0,,10457,10457,8883,8655,1574,1802,2602704
1357,23558,39848,39848,28205,28682,11643,11166,38134.0,,28195.0,,9939.0,,38930,38930,26753,26958,12177,11972,2602803
1358,23574,160540,160540,136417,137297,24123,23243,153062.0,,130451.0,,22611.0,,146324,146324,130265,130315,16059,16009,2602902
1359,23590,25947,25947,20248,20221,5699,5726,24941.0,,20211.0,,4730.0,,24542,24542,18575,17835,5967,6707,2603009
1360,23612,16019,16019,12916,12926,3103,3093,15554.0,,12591.0,,2963.0,,15316,15316,11971,12111,3345,3205,2603108
1361,23639,19989,19989,14709,14835,5280,5154,19700.0,,14659.0,,5041.0,,19506,19506,13762,14133,5744,5373,2603207
1362,23655,7451,7451,6289,6346,1162,1105,7065.0,,6115.0,,950.0,,6401,6401,5461,5394,940,1007,2603306
1363,23671,6598,6598,5295,5293,1303,1305,6154.0,,5412.0,,742.0,,5743,5743,4887,4892,856,851,2603405
1364,23698,14883,14883,12337,12600,2546,2283,14395.0,,12195.0,,2200.0,,13941,13941,11375,11443,2566,2498,2603504
1365,23710,7443,7443,5886,5950,1557,1493,7365.0,,6219.0,,1146.0,,7167,7167,5752,5801,1415,1366,2603603
1366,23736,17016,17016,13535,13547,3481,3469,16409.0,,13258.0,,3151.0,,16172,16172,12452,12337,3720,3835,2603702
1367,23752,16108,16108,11801,11960,4307,4148,15779.0,,11961.0,,3818.0,,15870,15870,10684,10919,5186,4951,2603801
1368,23779,15932,15932,12311,12461,3621,3471,15139.0,,12191.0,,2948.0,,14623,14623,11219,11314,3404,3309,2603900
1369,23795,56225,56225,48341,49271,7884,6954,53138.0,,46252.0,,6886.0,,50181,50181,44967,45300,5214,4881,2604007
1370,23817,239299,239299,204949,208045,34350,31254,225164.0,,186633.0,,38531.0,,216900,216900,184238,185991,32662,30909,2604106
1371,23833,25578,25578,19702,19734,5876,5844,24809.0,,19841.0,,4968.0,,24486,24486,18678,18186,5808,6300,2604205
1372,23850,9944,9944,7546,7210,2398,2734,9668.0,,7670.0,,1998.0,,9744,9744,7108,6839,2636,2905,2604304
1373,23876,11057,11057,9249,9305,1808,1752,10710.0,,9662.0,,1048.0,,10098,10098,8864,8778,1234,1320,2604403
1374,23892,18885,18885,15452,15848,3433,3037,18507.0,,15500.0,,3007.0,,17875,17875,14050,14057,3825,3818,2604502
1375,23914,20811,20811,15827,16237,4984,4574,20589.0,,16458.0,,4131.0,,19714,19714,14605,14671,5109,5043,2604601
1376,23930,13891,13891,9733,9799,4158,4092,13571.0,,10217.0,,3354.0,,13603,13603,9209,9119,4394,4484,2604700
1377,23957,10897,10897,8430,8449,2467,2448,10557.0,,9122.0,,1435.0,,10030,10030,8295,8142,1735,1888,2604809
1378,23973,15343,15343,11802,11823,3541,3520,15335.0,,12399.0,,2936.0,,15004,15004,10931,10460,4073,4544,2604908
1379,23990,19659,19659,15826,16004,3833,3655,19445.0,,16120.0,,3325.0,,18839,18839,14434,14678,4405,4161,2605004
1380,24015,28603,28603,21450,21800,7153,6803,27133.0,,21361.0,,5772.0,,26661,26661,20079,20137,6582,6524,2605103
1381,24031,47402,47402,39361,39518,8041,7884,45632.0,,38495.0,,7137.0,,45315,45315,38344,38164,6971,7151,2605202
1382,24058,27669,27669,21368,21919,6301,5750,26460.0,,22115.0,,4345.0,,25344,25344,20095,20585,5249,4759,2605301
1383,24074,18399,18399,14584,14864,3815,3535,18223.0,,15368.0,,2855.0,,17453,17453,13685,13577,3768,3876,2605400
1384,24090,9958,9958,8099,8246,1859,1712,9689.0,,8424.0,,1265.0,,9266,9266,7444,7432,1822,1834,2605509
1385,24112,16264,16264,12619,12828,3645,3436,15801.0,,12857.0,,2944.0,,15215,15215,12477,12563,2738,2652,2605608
1386,24139,23986,23986,18978,18672,5008,5314,23058.0,,18640.0,,4418.0,,23443,23443,18150,17411,5293,6032,2605707
1387,24155,11974,11974,10253,10373,1721,1601,11681.0,,10719.0,,962.0,,10924,10924,9537,9499,1387,1425,2605806
1388,24171,15333,15333,11771,11819,3562,3514,15178.0,,12460.0,,2718.0,,14317,14317,11451,11521,2866,2796,2605905
1389,24198,95768,95768,78742,79768,17026,16000,90841.0,,71355.0,,19486.0,,88881,88881,72215,73336,16666,15545,2606002
1390,24210,22630,22630,18558,19094,4072,3536,21832.0,,18330.0,,3502.0,,21401,21401,17883,17926,3518,3475,2606101
1391,24236,61100,61100,52399,52547,8701,8553,58494.0,,50150.0,,8344.0,,57663,57663,48981,49022,8682,8641,2606200
1392,24252,6732,6732,5631,5663,1101,1069,6517.0,,5962.0,,555.0,,5571,5571,4818,4759,753,812,2606309
1393,24279,68958,68958,54313,55930,14645,13028,67209.0,,53527.0,,13682.0,,64264,64264,49624,49868,14640,14396,2606408
1394,24295,15936,15936,11048,11171,4888,4765,15516.0,,11551.0,,3965.0,,15771,15771,10550,10480,5221,5291,2606507
1395,24317,20859,20859,15433,15382,5426,5477,20081.0,,15931.0,,4150.0,,20055,20055,14551,14258,5504,5797,2606606
1396,24333,6930,6930,5468,5508,1462,1422,6840.0,,5974.0,,866.0,,6422,6422,5027,4943,1395,1479,2606705
1397,24350,85872,85872,72748,73557,13124,12315,81743.0,,67892.0,,13851.0,,78964,78964,67226,67515,11738,11449,2606804
1398,24376,8870,8870,7042,7114,1828,1756,8616.0,,7223.0,,1393.0,,8447,8447,6657,6580,1790,1867,2606903
1399,24392,14295,14295,11076,11075,3219,3220,13414.0,,11245.0,,2169.0,,13337,13337,10120,10069,3217,3268,2607000
1400,24414,4074,4074,3397,3452,677,622,3908.0,,3529.0,,379.0,,3765,3765,3121,3146,644,619,2607109
1401,24430,80766,80766,67065,67291,13701,13475,76990.0,,66637.0,,10353.0,,71570,71570,58467,58712,13103,12858,2607208
1402,24457,22650,22650,16862,17188,5788,5462,21779.0,,17085.0,,4694.0,,22094,22094,15644,15578,6450,6516,2607307
1403,24473,4351,4351,3599,3421,752,930,4237.0,,3923.0,,314.0,,3895,3895,3281,3132,614,763,2607406
1404,24490,19649,19649,14734,14920,4915,4729,18614.0,,15129.0,,3485.0,,17774,17774,13338,13321,4436,4453,2607505
1405,24511,17552,17552,14028,14257,3524,3295,17264.0,,13754.0,,3510.0,,16969,16969,13720,13561,3249,3408,2607604
1406,24538,12451,12451,9420,9595,3031,2856,12338.0,,9854.0,,2484.0,,12026,12026,9039,9040,2987,2986,2607703
1407,24554,14012,14012,10794,10776,3218,3236,13840.0,,11226.0,,2614.0,,13676,13676,10557,10201,3119,3475,2607802
1408,24570,478789,478789,387892,391528,90897,87261,454915.0,,348251.0,,106664.0,,452277,452277,368958,366029,83319,86248,2607901
1409,24597,14817,14817,11520,11585,3297,3232,14437.0,,11985.0,,2452.0,,13944,13944,10672,10046,3272,3898,2608008
1410,24619,25359,25359,18862,19262,6497,6097,24580.0,,19651.0,,4929.0,,23784,23784,17434,17292,6350,6492,2608107
1411,24635,13574,13574,10124,10933,3450,2641,13268.0,,10989.0,,2279.0,,12688,12688,9074,8663,3614,4025,2608206
1412,24651,12325,12325,10141,10233,2184,2092,11748.0,,9602.0,,2146.0,,11117,11117,9140,9235,1977,1882,2608305
1413,24678,12141,12141,9201,9244,2940,2897,11443.0,,9408.0,,2035.0,,11266,11266,8544,8594,2722,2672,2608404
1414,24694,18606,18606,14812,15069,3794,3537,18606.0,,15374.0,,3232.0,,17726,17726,13845,13830,3881,3896,2608503
1415,24716,11116,11116,8480,8584,2636,2532,10759.0,,8580.0,,2179.0,,10765,10765,8090,8095,2675,2670,2608602
1416,24732,12250,12250,9129,9152,3121,3098,12188.0,,9537.0,,2651.0,,12278,12278,8515,8355,3763,3923,2608701
1417,24759,29996,29996,24732,25122,5264,4874,28494.0,,24660.0,,3834.0,,27448,27448,22352,22418,5096,5030,2608800
1418,24775,44559,44559,37227,37655,7332,6904,42706.0,,35637.0,,7069.0,,42257,42257,35736,35478,6521,6779,2608909
1419,24791,19885,19885,15198,15349,4687,4536,19399.0,,15546.0,,3853.0,,19201,19201,14706,14396,4495,4805,2609006
1420,24813,10678,10678,8596,8747,2082,1931,10171.0,,8925.0,,1246.0,,9404,9404,7917,7920,1487,1484,2609105
1421,24830,9427,9427,6379,6089,3048,3338,9631.0,,7102.0,,2529.0,,9942,9942,6210,5867,3732,4075,2609204
1422,24856,11660,11660,9032,9088,2628,2572,11270.0,,9533.0,,1737.0,,10664,10664,8729,8782,1935,1882,2609303
1423,24872,48069,48069,40094,40621,7975,7448,46650.0,,38369.0,,8281.0,,45631,45631,38104,38276,7527,7355,2609402
1424,24899,25374,25374,21087,21601,4287,3773,24738.0,,21053.0,,3685.0,,24047,24047,20246,20480,3801,3567,2609501
1425,24910,297800,297800,258606,261508,39194,36292,282952.0,,231439.0,,51513.0,,276081,276081,247087,246516,28994,29565,2609600
1426,24937,20687,20687,14760,14707,5927,5980,20424.0,,15052.0,,5372.0,,20297,20297,13888,13385,6409,6912,2609709
1427,24953,12540,12540,9658,9582,2882,2958,12450.0,,10135.0,,2315.0,,11903,11903,8997,8565,2906,3338,2609808
1428,24970,50751,50751,37294,38020,13457,12731,49709.0,,39361.0,,10348.0,,47525,47525,34374,34263,13151,13262,2609907
1429,24996,40521,40521,31576,32097,8945,8424,39806.0,,31933.0,,7873.0,,39703,39703,31232,31185,8471,8518,2610004
1430,25011,6651,6651,4498,4559,2153,2092,6596.0,,4698.0,,1898.0,,6853,6853,4514,4515,2339,2338,2610103
1431,25038,22030,22030,15535,15548,6495,6482,21699.0,,16217.0,,5482.0,,21481,21481,14264,14379,7217,7102,2610202
1432,25054,10831,10831,8814,8849,2017,1982,10167.0,,8605.0,,1562.0,,9515,9515,7846,7929,1669,1586,2610301
1433,25070,18133,18133,14493,14363,3640,3770,17528.0,,14648.0,,2880.0,,17880,17880,13774,13080,4106,4800,2610400
1434,25097,25634,25634,20765,20948,4869,4686,24783.0,,21375.0,,3408.0,,24303,24303,19315,19058,4988,5245,2610509
1435,25119,46069,46069,37036,37648,9033,8421,44511.0,,36620.0,,7891.0,,41749,41749,33850,33494,7899,8255,2610608
1436,25135,228366,228366,195658,197777,32708,30589,216859.0,216859.0,176363.0,169732.0,40496.0,47127.0,208363,208363,183319,182818,25044,25545,2610707
1437,25151,19556,19556,14657,14830,4899,4726,19019.0,,15140.0,,3879.0,,18616,18616,13251,13145,5365,5471,2610806
1438,25178,50776,50776,38295,38647,12481,12129,49337.0,,36967.0,,12370.0,,50144,50144,35932,35726,14212,14418,2610905
1439,25194,25393,25393,19484,19461,5909,5932,24674.0,,19611.0,,5063.0,,23935,23935,18681,18751,5254,5184,2611002
1440,25216,229925,229925,190571,193237,39354,36688,210359.0,,170622.0,,39737.0,,198599,198599,166166,167912,32433,30687,2611101
1441,25232,10150,10150,7853,7946,2297,2204,10124.0,,8335.0,,1789.0,,9834,9834,7337,7383,2497,2451,2611200
1442,25259,19151,19151,16723,16969,2428,2182,18423.0,,16550.0,,1873.0,,17150,17150,15279,15440,1871,1710,2611309
1443,25275,11447,11447,8756,8796,2691,2651,11630.0,,9440.0,,2190.0,,11120,11120,8478,8234,2642,2886,2611408
1444,25291,17914,17914,11555,11612,6359,6302,17942.0,,12683.0,,5259.0,,17821,17821,11065,10905,6756,6916,2611507
1445,25313,1215546,1215546,1043107,1053188,172439,162358,1157324.0,1157324.0,927167.0,911314.0,230157.0,246010.0,1155816,1155816,1006719,1000611,149097,155205,2611606
1446,25330,19656,19656,17196,17551,2460,2105,18875.0,,17508.0,,1367.0,,17261,17261,15248,15380,2013,1881,2611705
1447,25356,28236,28236,22427,22446,5809,5790,27255.0,,22751.0,,4504.0,,26346,26346,21916,21559,4430,4787,2611804
1448,25372,16363,16363,12811,12885,3552,3478,16359.0,,13332.0,,3027.0,,16291,16291,12475,12436,3816,3855,2611903
1449,25399,11024,11024,9541,9606,1483,1418,10683.0,,9684.0,,999.0,,10113,10113,8962,8874,1151,1239,2612000
1450,25410,7372,7372,5448,5451,1924,1921,7300.0,,6224.0,,1076.0,,6754,6754,4941,4636,1813,2118,2612109
1451,25437,41992,41992,33846,34437,8146,7555,40054.0,,32873.0,,7181.0,,39334,39334,31840,32230,7494,7104,2612208
1452,25453,13513,13513,9346,9423,4167,4090,13103.0,,9490.0,,3613.0,,13356,13356,8917,8913,4439,4443,2612307
1453,25470,16046,16046,12836,13051,3210,2995,15757.0,,13308.0,,2449.0,,15432,15432,12078,12428,3354,3004,2612406
1454,25496,61813,61813,53157,54055,8656,7758,57422.0,,49956.0,,7466.0,,55569,55569,47747,47281,7822,8288,2612505
1455,25518,31029,31029,24091,24064,6938,6965,30011.0,,24523.0,,5488.0,,29051,29051,22271,21714,6780,7337,2612604
1456,25534,11197,11197,8928,9202,2269,1995,10880.0,,9480.0,,1400.0,,10403,10403,8413,8614,1990,1789,2612703
1457,25550,8010,8010,6395,6431,1615,1579,7653.0,,6502.0,,1151.0,,7160,7160,6044,5916,1116,1244,2612802
1458,25577,8857,8857,5879,5895,2978,2962,8878.0,,6513.0,,2365.0,,8555,8555,5379,5371,3176,3184,2612901
1459,25593,36623,36623,27816,28045,8807,8578,36063.0,,27358.0,,8705.0,,36155,36155,25525,25635,10630,10520,2613008
1460,25615,30216,30216,25386,25548,4830,4668,29535.0,,25044.0,,4491.0,,29064,29064,23706,23898,5358,5166,2613107
1461,25631,18891,18891,14061,14549,4830,4342,18494.0,,14580.0,,3914.0,,17764,17764,12463,12614,5301,5150,2613206
1462,25658,17353,17353,14070,14203,3283,3150,16822.0,,14240.0,,2582.0,,16387,16387,13106,13216,3281,3171,2613305
1463,25674,16216,16216,12265,12036,3951,4180,16226.0,,13510.0,,2716.0,,14117,14117,10736,10489,3381,3628,2613404
1464,25690,26580,26580,20239,20673,6341,5907,25116.0,,19107.0,,6009.0,,24047,24047,19046,19018,5001,5029,2613503
1465,25712,23156,23156,18630,18831,4526,4325,22124.0,,18473.0,,3651.0,,21385,21385,17481,17610,3904,3775,2613602
1466,25739,77682,77682,67299,68371,10383,9311,74802.0,,65096.0,,9706.0,,69852,69852,62918,63654,6934,6198,2613701
1467,25755,14178,14178,11286,11394,2892,2784,13771.0,,11388.0,,2383.0,,13555,13555,10691,10592,2864,2963,2613800
1468,25771,60340,60340,49095,49573,11245,10767,58477.0,,47574.0,,10903.0,,56757,56757,46079,45883,10678,10874,2613909
1469,25798,16167,16167,12228,12194,3939,3973,15457.0,,12300.0,,3157.0,,15649,15649,11476,11090,4173,4559,2614006
1470,25810,26221,26221,19415,19225,6806,6996,25936.0,,19256.0,,6680.0,,26205,26205,19484,19052,6721,7153,2614105
1471,25836,28418,28418,22300,22626,6118,5792,27667.0,,22938.0,,4729.0,,27172,27172,21553,21764,5619,5408,2614204
1472,25852,9658,9658,7527,7692,2131,1966,9227.0,,7741.0,,1486.0,,8900,8900,6848,6954,2052,1946,2614303
1473,25879,5584,5584,4385,4458,1199,1126,5422.0,,4741.0,,681.0,,5090,5090,4017,4149,1073,941,2614402
1474,25895,45992,45992,38180,38915,7812,7077,44461.0,,37628.0,,6833.0,,43075,43075,36527,36865,6548,6210,2614501
1475,25917,20583,20583,16508,16813,4075,3770,19821.0,,16978.0,,2843.0,,19569,19569,15433,15815,4136,3754,2614600
1476,25933,10348,10348,8470,8458,1878,1890,10146.0,,8690.0,,1456.0,,9853,9853,7918,8015,1935,1838,2614709
1477,25950,17255,17255,13578,13583,3677,3672,16381.0,,14022.0,,2359.0,,15456,15456,12320,12286,3136,3170,2614808
1478,25976,23859,23859,19170,19575,4689,4284,23388.0,,19405.0,,3983.0,,23055,23055,18522,19054,4533,4001,2607653
1479,25992,20701,20701,17500,17652,3201,3049,20055.0,,17171.0,,2884.0,,19582,19582,15527,15565,4055,4017,2615003
1480,26018,6645,6645,5031,5106,1614,1539,6591.0,,5267.0,,1324.0,,6202,6202,4824,4748,1378,1454,2615102
1481,26034,8224,8224,6947,6919,1277,1305,7870.0,,6972.0,,898.0,,7857,7857,6583,6320,1274,1537,2615201
1482,26050,42475,42475,33973,34374,8502,8101,41498.0,,33974.0,,7524.0,,41233,41233,32706,32111,8527,9122,2615300
1483,26077,32456,32456,27511,27566,4945,4890,31171.0,,26481.0,,4690.0,,30297,30297,24383,24257,5914,6040,2615409
1484,26093,11156,11156,9359,9555,1797,1601,10608.0,,9443.0,,1165.0,,10140,10140,8655,8732,1485,1408,2615508
1485,26115,22976,22976,17462,17596,5514,5380,22278.0,,17850.0,,4428.0,,22535,22535,16429,16166,6106,6369,2615607
1486,26131,11500,11500,9446,9563,2054,1937,11151.0,,9318.0,,1833.0,,10633,10633,8999,8974,1634,1659,2615706
1487,26158,18386,18386,12504,12659,5882,5727,17889.0,,12983.0,,4906.0,,17459,17459,11389,11375,6070,6084,2615805
1488,26174,8099,8099,6469,6586,1630,1513,7890.0,,6763.0,,1127.0,,7392,7392,6066,6072,1326,1320,2615904
1489,26190,14501,14501,11259,11520,3242,2981,14272.0,,11952.0,,2320.0,,13409,13409,10196,10231,3213,3178,2616001
1490,26212,7865,7865,6412,6387,1453,1478,7459.0,,6411.0,,1048.0,,7032,7032,6019,5930,1013,1102,2616100
1491,26239,16560,16560,13250,13545,3310,3015,16348.0,,13737.0,,2611.0,,15804,15804,12204,12120,3600,3684,2616209
1492,26255,22126,22126,17316,17581,4810,4545,21771.0,,17517.0,,4254.0,,21548,21548,16948,17022,4600,4526,2616308
1493,26271,99320,99320,85030,86748,14290,12572,94944.0,,80788.0,,14156.0,,92760,92760,81037,81623,11723,11137,2616407
1494,26298,120503,120503,104596,105943,15907,14560,114394.0,,96469.0,,17925.0,,108998,108998,99107,99266,9891,9732,2603454
1495,26310,84193,84193,69050,69732,15143,14461,83587.0,,67606.0,,15981.0,,81210,81210,67116,66644,14094,14566,2600054
1496,26336,18973,18973,16370,16417,2603,2556,18208.0,,15968.0,,2240.0,,17636,17636,15303,14999,2333,2637,2607752
1497,27006,11081,11081,8883,8518,2198,2563,10382.0,,8677.0,,1705.0,,9432,9432,7712,7314,1720,2118,2706448
1498,27014,15950,15950,11136,11128,4814,4822,15296.0,,11597.0,,3699.0,,14879,14879,10886,10758,3993,4121,2700102
1499,27022,9079,9079,6721,6712,2358,2367,8736.0,,7046.0,,1690.0,,8282,8282,6517,6431,1765,1851,2706422
1500,27030,12675,12675,9039,8880,3636,3795,12411.0,,9514.0,,2897.0,,12613,12613,8834,8464,3779,4149,2700201
1501,27049,12008,12008,8259,8300,3749,3708,11684.0,,8367.0,,3317.0,,11620,11620,7956,8063,3664,3557,2702553
1502,27057,150627,150627,121879,123406,28748,27221,143187.0,,115778.0,,27409.0,,141054,141054,115893,113635,25161,27419,2700300
1503,27065,7943,7943,6334,6050,1609,1893,7765.0,,6705.0,,1060.0,,7264,7264,5714,5145,1550,2119,2703759
1504,27073,31344,31344,23655,22631,7689,8713,30331.0,,23630.0,,6701.0,,30353,30353,22747,21315,7606,9038,2700409
1505,27081,5666,5666,4190,4066,1476,1600,5548.0,,4448.0,,1100.0,,5250,5250,3838,3617,1412,1633,2701357
1506,27090,12534,12534,9723,9390,2811,3144,11987.0,,9763.0,,2224.0,,11460,11460,8796,8418,2664,3042,2700508
1507,27111,7332,7332,6137,5927,1195,1405,6897.0,,5727.0,,1170.0,,6465,6465,5349,5088,1116,1377,2700607
1508,27138,13071,13071,9937,9997,3134,3074,12705.0,,10630.0,,2075.0,,12173,12173,9237,8811,2936,3362,2700706
1509,27154,4978,4978,3659,3539,1319,1439,4836.0,,3889.0,,947.0,,4796,4796,3668,3422,1128,1374,2700805
1510,27170,6038,6038,4653,4454,1385,1584,5789.0,,5031.0,,758.0,,5134,5134,3831,3599,1303,1535,2700904
1511,27197,19605,19605,14195,14092,5410,5513,19280.0,,14528.0,,4752.0,,19536,19536,13635,13368,5901,6168,2701001
1512,27219,9101,9101,6369,6127,2732,2974,8748.0,,6635.0,,2113.0,,8057,8057,5554,5230,2503,2827,2701100
1513,27235,8465,8465,6200,6033,2265,2432,8047.0,,6121.0,,1926.0,,8026,8026,5933,5587,2093,2439,2701209
1514,27251,14548,14548,10501,10190,4047,4358,13965.0,,10591.0,,3374.0,,14260,14260,10080,9711,4180,4549,2701308
1515,27278,25843,25843,18902,18717,6941,7126,24642.0,,18501.0,,6141.0,,23928,23928,17391,16900,6537,7028,2701407
1516,27294,8956,8956,6885,6682,2071,2274,8218.0,,6931.0,,1287.0,,8148,8148,6094,6094,2054,2054,2701506
1517,27316,13660,13660,9695,9480,3965,4180,13355.0,,10245.0,,3110.0,,13116,13116,9344,8920,3772,4196,2701605
1518,27332,12940,12940,9932,9426,3008,3514,12820.0,,10364.0,,2456.0,,12852,12852,9793,9027,3059,3825,2701704
1519,27359,6965,6965,5234,5078,1731,1887,6536.0,,5196.0,,1340.0,,6342,6342,4686,4650,1656,1692,2701803
1520,27375,6097,6097,4617,4401,1480,1696,5836.0,,4674.0,,1162.0,,5862,5862,4235,4077,1627,1785,2701902
1521,27391,8912,8912,6911,6896,2001,2016,8595.0,,6986.0,,1609.0,,8380,8380,6337,6334,2043,2046,2702009
1522,27413,14861,14861,10828,10360,4033,4501,14813.0,,11244.0,,3569.0,,14949,14949,10572,9906,4377,5043,2702108
1523,27430,5018,5018,4210,4028,808,990,4965.0,,4365.0,,600.0,,4547,4547,3773,3610,774,937,2702207
1524,27456,40193,40193,30487,29593,9706,10600,38667.0,,30532.0,,8135.0,,38411,38411,28842,27631,9569,10780,2702306
1525,27472,39075,39075,29601,29345,9474,9730,37477.0,,28673.0,,8804.0,,37082,37082,28523,27825,8559,9257,2702405
1526,27499,9311,9311,6754,6592,2557,2719,8942.0,,7338.0,,1604.0,,8522,8522,5993,5792,2529,2730,2702504
1527,27510,17920,17920,13989,14296,3931,3624,17344.0,,14456.0,,2888.0,,16909,16909,12870,13312,4039,3597,2702603
1528,27537,3521,3521,2572,2478,949,1043,3486.0,,2891.0,,595.0,,3416,3416,2432,2256,984,1160,2702702
1529,27553,8678,8678,6452,6161,2226,2517,8261.0,,6338.0,,1923.0,,8469,8469,6183,5771,2286,2698,2702801
1530,27570,27348,27348,20271,20629,7077,6719,26069.0,,20633.0,,5436.0,,25339,25339,18495,18936,6844,6403,2702900
1531,27596,11372,11372,8340,8337,3032,3035,11059.0,,8839.0,,2220.0,,10722,10722,8083,7952,2639,2770,2703007
1532,27618,20128,20128,14469,14483,5659,5645,19425.0,,14625.0,,4800.0,,19259,19259,13654,13713,5605,5546,2703106
1533,27634,17555,17555,13519,13390,4036,4165,17020.0,,13687.0,,3333.0,,16758,16758,12748,12587,4010,4171,2703205
1534,27650,13307,13307,9489,9391,3818,3916,12898.0,,9946.0,,2952.0,,12301,12301,8620,8468,3681,3833,2703304
1535,27677,4911,4911,3729,3645,1182,1266,4911.0,,4167.0,,744.0,,4766,4766,3638,3530,1128,1236,2703403
1536,27693,5691,5691,4418,4062,1273,1629,5616.0,,4823.0,,793.0,,5384,5384,4082,3669,1302,1715,2703502
1537,27715,7175,7175,5723,5426,1452,1749,6726.0,,5823.0,,903.0,,6323,6323,4870,4418,1453,1905,2703601
1538,27731,4987,4987,3923,3827,1064,1160,4793.0,,4109.0,,684.0,,4636,4636,3619,3473,1017,1163,2703700
1539,27758,14305,14305,10856,10287,3449,4018,14056.0,,11168.0,,2888.0,,13423,13423,10247,9670,3176,3753,2703809
1540,27774,4482,4482,3310,2984,1172,1498,4322.0,,3663.0,,659.0,,4185,4185,3003,2592,1182,1593,2703908
1541,27790,19830,19830,14978,14745,4852,5085,19130.0,,15435.0,,3695.0,,18963,18963,13707,13458,5256,5505,2704005
1542,27812,15113,15113,11945,12095,3168,3018,14662.0,,12612.0,,2050.0,,14189,14189,10978,11161,3211,3028,2704104
1543,27839,19066,19066,14834,14797,4232,4269,17753.0,,14406.0,,3347.0,,17625,17625,13096,13057,4529,4568,2704203
1544,27855,627485,627485,507606,511305,119879,116180,592388.0,592388.0,444070.0,427649.0,148318.0,164739.0,595514,595514,485824,479620,109690,115894,2704302
1545,27871,15258,15258,11376,11255,3882,4003,14352.0,,11782.0,,2570.0,,14396,14396,10800,10179,3596,4217,2704401
1546,27898,22524,22524,17566,17469,4958,5055,20788.0,,17087.0,,3701.0,,19888,19888,15328,14945,4560,4943,2704500
1547,27910,8135,8135,5960,5838,2175,2297,7831.0,,6026.0,,1805.0,,7796,7796,5566,5447,2230,2349,2704609
1548,27936,41017,41017,33228,32043,7789,8974,38343.0,,31667.0,,6676.0,,35900,35900,28027,26588,7873,9312,2704708
1549,27952,10337,10337,8138,7767,2199,2570,10172.0,,8169.0,,2003.0,,10241,10241,7885,7291,2356,2950,2704807
1550,27979,3541,3541,2917,2789,624,752,3433.0,,3044.0,,389.0,,3325,3325,2727,2481,598,844,2704906
1551,27995,17752,17752,12435,12118,5317,5634,17302.0,,13458.0,,3844.0,,16836,16836,11947,11701,4889,5135,2705002
1552,28010,18503,18503,13633,13385,4870,5118,18223.0,,14196.0,,4027.0,,18639,18639,13655,13129,4984,5510,2705101
1553,28037,13612,13612,10529,10190,3083,3422,12895.0,,10255.0,,2640.0,,12674,12674,9838,9356,2836,3318,2705200
1554,28053,4910,4910,3718,3664,1192,1246,4746.0,,3986.0,,760.0,,4605,4605,3540,3408,1065,1197,2705309
1555,28070,5980,5980,4330,4282,1650,1698,5781.0,,4585.0,,1196.0,,5738,5738,4194,4035,1544,1703,2705408
1556,28096,20081,20081,15210,14374,4871,5707,19057.0,,14309.0,,4748.0,,19166,19166,14725,13488,4441,5678,2705507
1557,28118,9866,9866,7303,6572,2563,3294,9422.0,,7492.0,,1930.0,,9458,9458,6536,5816,2922,3642,2705606
1558,28134,16034,16034,12068,11909,3966,4125,15533.0,,12685.0,,2848.0,,14854,14854,11260,10888,3594,3966,2705705
1559,28150,7454,7454,5503,5519,1951,1935,7142.0,,5781.0,,1361.0,,6834,6834,5007,5030,1827,1804,2705804
1560,28177,4833,4833,3608,3400,1225,1433,4657.0,,3928.0,,729.0,,4459,4459,3347,3202,1112,1257,2705903
1561,28193,9641,9641,7352,7236,2289,2405,9174.0,,7547.0,,1627.0,,8822,8822,6783,6484,2039,2338,2706000
1562,28215,9229,9229,7163,7216,2066,2013,8455.0,,7049.0,,1406.0,,8194,8194,6314,6268,1880,1926,2706109
1563,28231,4755,4755,3451,3206,1304,1549,4563.0,,4048.0,,515.0,,4296,4296,3144,2846,1152,1450,2706208
1564,28258,52692,52692,41497,40221,11195,12471,50805.0,,38811.0,,11994.0,,50181,50181,38832,36890,11349,13291,2706307
1565,28274,18801,18801,14161,13455,4640,5346,18122.0,,14461.0,,3661.0,,17997,17997,13547,12281,4450,5716,2706406
1566,28290,11917,11917,9424,8962,2493,2955,11576.0,,9631.0,,1945.0,,11197,11197,8443,7820,2754,3377,2706505
1567,28312,6259,6259,4935,4664,1324,1595,6059.0,,5003.0,,1056.0,,6042,6042,4731,4298,1311,1744,2706604
1568,28339,42150,42150,31642,30967,10508,11183,40746.0,,30544.0,,10202.0,,40831,40831,29309,28232,11522,12599,2706703
1569,28355,13590,13590,10406,9718,3184,3872,13174.0,,10813.0,,2361.0,,13059,13059,9583,8949,3476,4110,2706802
1570,28371,27285,27285,21590,21396,5695,5889,26133.0,,21014.0,,5119.0,,25646,25646,19977,19246,5669,6400,2706901
1571,28398,2673,2673,2149,2014,524,659,2581.0,,2244.0,,337.0,,2483,2483,1982,1797,501,686,2707008
1572,28410,18931,18931,13998,14082,4933,4849,18050.0,,14338.0,,3712.0,,17748,17748,13036,13094,4712,4654,2707107
1573,28436,10470,10470,7959,7850,2511,2620,9979.0,,7993.0,,1986.0,,9794,9794,7257,7186,2537,2608,2707206
1574,28452,20930,20930,15835,14937,5095,5993,20337.0,,16330.0,,4007.0,,20091,20091,14665,13077,5426,7014,2707305
1575,28479,7062,7062,5611,5269,1451,1793,6899.0,,5874.0,,1025.0,,6565,6565,4910,4386,1655,2179,2707404
1576,28495,16153,16153,12705,12324,3448,3829,15341.0,,12819.0,,2522.0,,14812,14812,11630,11258,3182,3554,2707503
1577,28517,10048,10048,7657,7349,2391,2699,9762.0,,7467.0,,2295.0,,9795,9795,7511,6913,2284,2882,2707602
1578,28533,62255,62255,50977,49748,11278,12507,57632.0,,46916.0,,10716.0,,54500,54500,45175,42953,9325,11547,2707701
1579,28550,5569,5569,4254,4064,1315,1505,5465.0,,4459.0,,1006.0,,4998,4998,3770,3550,1228,1448,2707800
1580,28576,6101,6101,5086,4978,1015,1123,5860.0,,4965.0,,895.0,,5783,5783,4644,4580,1139,1203,2707909
1581,28592,32098,32098,25149,24941,6949,7157,30701.0,,24098.0,,6603.0,,30745,30745,23887,23378,6858,7367,2708006
1582,28614,9009,9009,6693,6761,2316,2248,8614.0,,6960.0,,1654.0,,8346,8346,6160,6183,2186,2163,2708105
1583,28630,6688,6688,5240,4904,1448,1784,6355.0,,5628.0,,727.0,,5907,5907,4597,4236,1310,1671,2708204
1584,28657,17375,17375,12923,12769,4452,4606,16815.0,,13066.0,,3749.0,,16688,16688,12664,12313,4024,4375,2708303
1585,28673,21640,21640,15421,15491,6219,6149,20765.0,,15861.0,,4904.0,,20495,20495,14999,14977,5496,5518,2708402
1586,28690,23467,23467,17172,16696,6295,6771,22885.0,,18117.0,,4768.0,,21863,21863,16314,15189,5549,6674,2708501
1587,28711,42525,42525,33283,32582,9242,9943,40030.0,,32065.0,,7965.0,,38995,38995,31026,29638,7969,9357,2708600
1588,28738,7374,7374,5742,5431,1632,1943,7170.0,,6275.0,,895.0,,6446,6446,4817,4495,1629,1951,2708709
1589,28754,25963,25963,19630,19550,6333,6413,24790.0,,19941.0,,4849.0,,24362,24362,18295,18051,6067,6311,2708808
1590,28770,12499,12499,10458,10219,2041,2280,11151.0,,9484.0,,1667.0,,9877,9877,8228,7862,1649,2015,2708907
1591,28797,5495,5495,3999,3916,1496,1579,5436.0,,4364.0,,1072.0,,5220,5220,3836,3685,1384,1535,2709004
1592,28819,14168,14168,10629,10742,3539,3426,13574.0,,10635.0,,2939.0,,13438,13438,9951,10117,3487,3321,2709103
1593,28835,18358,18358,13588,13283,4770,5075,17108.0,,13148.0,,3960.0,,17199,17199,12208,11810,4991,5389,2709202
1594,28851,46272,46272,34482,34105,11790,12167,44953.0,,34512.0,,10441.0,,44402,44402,33176,32259,11226,12143,2709301
1595,28878,20297,20297,15799,15254,4498,5043,19668.0,,15622.0,,4046.0,,19635,19635,14762,14077,4873,5558,2709400
1596,28894,19339,19339,15375,15723,3964,3616,18372.0,,15703.0,,2669.0,,17788,17788,13856,14048,3932,3740,2702355
1597,28916,9310,9310,6741,6791,2569,2519,8854.0,,6805.0,,2049.0,,8832,8832,6461,6390,2371,2442,2708956
1598,28932,30681,30681,21665,21647,9016,9034,29308.0,,21519.0,,7789.0,,29112,29112,20753,20488,8359,8624,2709152
1599,30007,70016,70016,55249,56457,14767,13559,65734.0,,52752.0,,12982.0,,53094,53094,41038,40564,12056,12530,2919553
1600,30031,20566,20566,16879,17306,3687,3260,19741.0,,17380.0,,2361.0,,19219,19219,15325,15378,3894,3841,2401453
1601,30058,81805,81805,63716,64424,18089,17381,79079.0,,63023.0,,16056.0,,76049,76049,62431,62569,13618,13480,2910727
1602,30660,8866,8866,6776,6834,2090,2032,8787.0,,7114.0,,1673.0,,8402,8402,6336,6128,2066,2274,2917334
1603,30678,9160,9160,7250,7209,1910,1951,8916.0,,7959.0,,957.0,,8165,8165,6361,6273,1804,1892,2917359
1604,30694,5034,5034,3499,3472,1535,1562,5097.0,,3828.0,,1269.0,,4904,4904,3238,3172,1666,1732,2918555
1605,30716,13521,13521,10184,10210,3337,3311,13118.0,,10465.0,,2653.0,,12789,12789,9156,8906,3633,3883,2901155
1606,30732,6303,6303,4670,4479,1633,1824,6299.0,,5143.0,,1156.0,,5918,5918,4603,4476,1315,1442,2902252
1607,30759,10995,10995,8708,8884,2287,2111,10752.0,,9181.0,,1571.0,,9809,9809,7601,7529,2208,2280,2903235
1608,30775,13743,13743,11294,11363,2449,2380,13335.0,,11535.0,,1800.0,,12566,12566,10726,10511,1840,2055,2903276
1609,30791,16355,16355,11917,11739,4438,4616,16245.0,,12885.0,,3360.0,,14953,14953,10759,10615,4194,4338,2904753
1610,30813,9851,9851,7562,7531,2289,2320,9677.0,,7931.0,,1746.0,,9269,9269,6840,6696,2429,2573,2906857
1611,30830,24750,24750,18951,19215,5799,5535,24053.0,,19079.0,,4974.0,,22621,22621,16962,16709,5659,5912,2906873
1612,30856,13369,13369,10230,10142,3139,3227,13111.0,,10710.0,,2401.0,,12341,12341,9167,8826,3174,3515,2906824
1613,30872,53827,53827,42347,42674,11480,11153,51756.0,,41127.0,,10629.0,,48604,48604,39337,38638,9267,9966,2910057
1614,30899,15959,15959,12320,12520,3639,3439,15855.0,,12693.0,,3162.0,,15099,15099,11115,11151,3984,3948,2910750
1615,30910,15701,15701,11700,11891,4001,3810,15563.0,,12388.0,,3175.0,,14330,14330,10348,10089,3982,4241,2910859
1616,30937,4530,4530,3458,3452,1072,1078,4406.0,,3752.0,,654.0,,4309,4309,3234,3105,1075,1204,2911253
1617,30953,7438,7438,4938,5075,2500,2363,7400.0,,5219.0,,2181.0,,7453,7453,4645,4658,2808,2795,2911659
1618,30970,11875,11875,9483,9552,2392,2323,11456.0,,10181.0,,1275.0,,10481,10481,8637,8686,1844,1795,2911857
1619,30996,19497,19497,14833,15018,4664,4479,18573.0,,15108.0,,3465.0,,17871,17871,13361,13177,4510,4694,2918357
1620,31003,5932,5932,4607,4552,1325,1380,5688.0,,4786.0,,902.0,,5473,5473,4414,4363,1059,1110,2806404
1621,31011,2686,2686,2238,2084,448,602,2666.0,,2446.0,,220.0,,2586,2586,2120,1900,466,686,2800100
1622,31038,16699,16699,13422,12983,3277,3716,16171.0,,13193.0,,2978.0,,15613,15613,12440,11971,3173,3642,2800209
1623,31054,423799,423799,352580,352657,71219,71142,404901.0,404901.0,303398.0,292304.0,101503.0,112597.0,407888,407888,333568,332995,74320,74893,2800308
1624,31070,9356,9356,7440,7371,1916,1985,9206.0,,7767.0,,1439.0,,9056,9056,7230,7070,1826,1986,2800407
1625,31097,13975,13975,11768,11590,2207,2385,13456.0,,11667.0,,1789.0,,13097,13097,10977,10668,2120,2429,2800506
1626,31119,25160,25160,19920,19715,5240,5445,23978.0,,19104.0,,4874.0,,21122,21122,16096,15848,5026,5274,2800605
1627,31135,7242,7242,5703,5428,1539,1814,6742.0,,5888.0,,854.0,,6352,6352,4895,4747,1457,1605,2800704
1628,31151,21500,21500,16937,16910,4563,4590,20880.0,,16825.0,,4055.0,,20686,20686,16329,16096,4357,4590,2800670
1629,31194,14828,14828,11806,11924,3022,2904,14346.0,,12037.0,,2309.0,,13994,13994,10921,11022,3073,2972,2801009
1630,31216,4341,4341,3532,3465,809,876,4306.0,,3850.0,,456.0,,4217,4217,3473,3313,744,904,2801108
1631,31232,23643,23643,17608,17506,6035,6137,22820.0,,17889.0,,4931.0,,22724,22724,17014,16959,5710,5765,2801207
1632,31259,26114,26114,20277,19877,5837,6237,24994.0,,20388.0,,4606.0,,24299,24299,19007,18368,5292,5931,2801306
1633,31275,16930,16930,13503,13275,3427,3655,16476.0,,13650.0,,2826.0,,16388,16388,12980,12894,3408,3494,2801405
1634,31291,13052,13052,9870,9797,3182,3255,13029.0,,10627.0,,2402.0,,13196,13196,10285,9979,2911,3217,2801504
1635,31313,5243,5243,4447,4444,796,799,5151.0,,4614.0,,537.0,,4910,4910,3936,3833,974,1077,2801603
1636,31330,14085,14085,10697,10683,3388,3402,13629.0,,10946.0,,2683.0,,12938,12938,9689,9631,3249,3307,2801702
1637,31356,7296,7296,6061,6086,1235,1210,7109.0,,6376.0,,733.0,,6966,6966,5693,5767,1273,1199,2804458
1638,31372,4274,4274,3645,3528,629,746,4009.0,,3683.0,,326.0,,3858,3858,3325,3089,533,769,2801900
1639,31399,4034,4034,3240,3159,794,875,3936.0,,3477.0,,459.0,,3673,3673,3013,2876,660,797,2802007
1640,31410,49285,49285,38695,38749,10590,10536,47613.0,,37873.0,,9740.0,,47425,47425,37663,37343,9762,10082,2802106
1641,31437,5782,5782,4851,4716,931,1066,5620.0,,4976.0,,644.0,,5491,5491,4599,4371,892,1120,2802205
1642,31453,13144,13144,10764,10738,2380,2406,12693.0,,11268.0,,1425.0,,12053,12053,9896,9923,2157,2130,2802304
1643,31470,2939,2939,2364,2299,575,640,2906.0,,2631.0,,275.0,,2603,2603,2210,2119,393,484,2802502
1644,31496,9162,9162,7462,7458,1700,1704,8852.0,,7492.0,,1360.0,,8760,8760,7089,7067,1671,1693,2802403
1645,31518,6042,6042,5113,5048,929,994,5869.0,,5326.0,,543.0,,5581,5581,4638,4474,943,1107,2802601
1646,31534,7492,7492,5661,5252,1831,2240,7331.0,,6068.0,,1263.0,,7051,7051,5274,5034,1777,2017,2802700
1647,31550,13026,13026,10002,9850,3024,3176,12514.0,,10246.0,,2268.0,,11860,11860,9293,8905,2567,2955,2802809
1648,31577,72255,72255,61514,60743,10741,11512,68745.0,,58508.0,,10237.0,,66769,66769,55819,55070,10950,11699,2802908
1649,31593,30699,30699,25498,25766,5201,4933,29643.0,,25166.0,,4477.0,,28526,28526,23481,23443,5045,5083,2803005
1650,31615,4542,4542,3727,3643,815,899,4438.0,,3921.0,,517.0,,4392,4392,3576,3446,816,946,2803104
1651,31631,28108,28108,22522,22216,5586,5892,27201.0,,22679.0,,4522.0,,25931,25931,21033,20569,4898,5362,2803203
1652,31658,14444,14444,11077,11025,3367,3419,14115.0,,11687.0,,2428.0,,13908,13908,11056,10783,2852,3125,2803302
1653,31674,11107,11107,8928,8682,2179,2425,10668.0,,9163.0,,1505.0,,10362,10362,8393,8078,1969,2284,2803401
1654,31690,77321,77321,64636,64770,12685,12551,74041.0,,61770.0,,12271.0,,72228,72228,59302,59272,12926,12956,2803500
1655,31712,22164,22164,17729,17473,4435,4691,21593.0,,18226.0,,3367.0,,21338,21338,17773,17290,3565,4048,2803609
1656,31739,6473,6473,5321,5377,1152,1096,6249.0,,5533.0,,716.0,,6055,6055,4867,4934,1188,1121,2803708
1657,31755,3894,3894,3133,3070,761,824,3880.0,,3407.0,,473.0,,3788,3788,3085,2918,703,870,2803807
1658,31771,9979,9979,8309,8272,1670,1707,9766.0,,8504.0,,1262.0,,9425,9425,7890,7851,1535,1574,2803906
1659,31798,12872,12872,10265,10153,2607,2719,12240.0,,10255.0,,1985.0,,12220,12220,10126,9952,2094,2268,2804003
1660,31810,9382,9382,7793,7712,1589,1670,9152.0,,7876.0,,1276.0,,8947,8947,7235,7184,1712,1763,2804102
1661,31836,11872,11872,9569,9398,2303,2474,11539.0,,9916.0,,1623.0,,10965,10965,8775,8657,2190,2308,2804201
1662,31852,7182,7182,5855,5615,1327,1567,6898.0,,6098.0,,800.0,,6702,6702,5525,5125,1177,1577,2804300
1663,31879,14091,14091,10784,10509,3307,3582,13828.0,,11238.0,,2590.0,,13933,13933,10787,10327,3146,3606,2804409
1664,31895,28114,28114,23598,23429,4516,4685,26611.0,,22140.0,,4471.0,,26014,26014,21718,21638,4296,4376,2804508
1665,31917,20853,20853,17235,17100,3618,3753,20368.0,,17410.0,,2958.0,,19886,19886,16381,16165,3505,3721,2804607
1666,31933,5730,5730,4753,4716,977,1014,5592.0,,4838.0,,754.0,,5532,5532,4604,4516,928,1016,2804706
1667,31950,113347,113347,95736,95158,17611,18189,109118.0,,92072.0,,17046.0,,103308,103308,86447,85742,16861,17566,2804805
1668,31976,11627,11627,8685,8377,2942,3250,11447.0,,9492.0,,1955.0,,11123,11123,8392,7976,2731,3147,2804904
1669,31992,3202,3202,2678,2639,524,563,3181.0,,2905.0,,276.0,,3065,3065,2485,2487,580,578,2805000
1670,32018,7457,7457,5749,5703,1708,1754,7302.0,,5848.0,,1454.0,,7233,7233,5403,5390,1830,1843,2805109
1671,32034,5480,5480,4501,4368,979,1112,5329.0,,4576.0,,753.0,,5161,5161,4088,3967,1073,1194,2805208
1672,32050,8349,8349,6348,6156,2001,2193,8169.0,,6684.0,,1485.0,,7794,7794,6201,5901,1593,1893,2805307
1673,32077,21567,21567,16576,16329,4991,5238,20599.0,,16835.0,,3764.0,,19761,19761,15657,15499,4104,4262,2805406
1674,32093,19149,19149,15251,15232,3898,3917,18674.0,,15224.0,,3450.0,,18180,18180,14369,14186,3811,3994,2805505
1675,32115,23505,23505,18933,18471,4572,5034,22581.0,,18785.0,,3796.0,,22217,22217,17860,17207,4357,5010,2805604
1676,32131,19809,19809,16068,15884,3741,3925,19362.0,,16121.0,,3241.0,,19508,19508,15726,15532,3782,3976,2805703
1677,32158,17268,17268,14185,14053,3083,3215,16817.0,,14235.0,,2582.0,,16298,16298,13359,13090,2939,3208,2805802
1678,32174,8110,8110,6482,6380,1628,1730,8019.0,,6793.0,,1226.0,,7800,7800,6266,6208,1534,1592,2805901
1679,32190,14367,14367,11911,11809,2456,2558,13809.0,,11677.0,,2132.0,,13645,13645,11058,11008,2587,2637,2806008
1680,32212,8648,8648,6782,6722,1866,1926,8509.0,,7145.0,,1364.0,,8315,8315,6678,6540,1637,1775,2806107
1681,32239,16830,16830,13969,13909,2861,2921,16159.0,,13760.0,,2399.0,,15228,15228,12647,12646,2581,2582,2806206
1682,32255,11452,11452,8562,8493,2890,2959,11417.0,,9359.0,,2058.0,,10407,10407,8128,7912,2279,2495,2806305
1683,32298,4129,4129,3466,3335,663,794,4073.0,,3635.0,,438.0,,3831,3831,3156,2962,675,869,2806503
1684,32310,9821,9821,7270,7181,2551,2640,9535.0,,7577.0,,1958.0,,8655,8655,6820,6702,1835,1953,2806602
1685,32336,58720,58720,49623,49225,9097,9495,56112.0,,46732.0,,9380.0,,54289,54289,45551,44922,8738,9367,2806701
1686,32352,8269,8269,6264,6427,2005,1842,8056.0,,6713.0,,1343.0,,7921,7921,5930,6136,1991,1785,2806800
1687,32379,3528,3528,2917,2844,611,684,3490.0,,3206.0,,284.0,,3499,3499,2839,2703,660,796,2806909
1688,32395,3962,3962,3203,3110,759,852,3993.0,,3447.0,,546.0,,3813,3813,3048,2882,765,931,2807006
1689,32417,35458,35458,29271,29202,6187,6256,34219.0,,28118.0,,6101.0,,33832,33832,28001,27532,5831,6300,2807105
1690,32433,6674,6674,5414,5327,1260,1347,6678.0,,5828.0,,850.0,,6345,6345,5310,5139,1035,1206,2807204
1691,32450,3528,3528,2994,2959,534,569,3424.0,,3194.0,,230.0,,3235,3235,2652,2643,583,592,2807303
1692,32476,40738,40738,33486,33482,7252,7256,38887.0,,32109.0,,6778.0,,38168,38168,31479,30856,6689,7312,2807402
1693,32492,9859,9859,7549,7574,2310,2285,9735.0,,7802.0,,1933.0,,9690,9690,7215,7205,2475,2485,2807501
1694,32514,18805,18805,14791,14833,4014,3972,18255.0,,14472.0,,3783.0,,17956,17956,13960,13842,3996,4114,2807600
1695,33014,7252,7252,5528,5564,1724,1688,7118.0,,5724.0,,1394.0,,6909,6909,5087,4983,1822,1926,2900108
1696,33030,14610,14610,11986,11999,2624,2611,14246.0,,12488.0,,1758.0,,12713,12713,10318,10080,2395,2633,2900207
1697,33057,12248,12248,9227,9118,3021,3130,12049.0,,9912.0,,2137.0,,11138,11138,8247,8010,2891,3128,2900306
1698,33065,11888,11888,9717,9861,2171,2027,11494.0,,9794.0,,1700.0,,11118,11118,8889,9010,2229,2108,2900355
1699,33073,13083,13083,9774,9705,3309,3378,12704.0,,10284.0,,2420.0,,12009,12009,8926,8518,3083,3491,2900405
1700,33090,8915,8915,6473,6527,2442,2388,8877.0,,7232.0,,1645.0,,8930,8930,5538,5609,3392,3321,2900504
1701,33111,4206,4206,3145,3160,1061,1046,4102.0,,3429.0,,673.0,,3787,3787,2915,2800,872,987,2900603
1702,33138,111809,111809,89573,91104,22236,20705,106935.0,,82869.0,,24066.0,,103306,103306,86017,86003,17289,17303,2900702
1703,33154,18853,18853,13548,13366,5305,5487,18525.0,,14423.0,,4102.0,,17010,17010,11647,11060,5363,5950,2900801
1704,33170,5170,5170,3663,3650,1507,1520,5215.0,,4027.0,,1188.0,,5022,5022,3374,3346,1648,1676,2900900
1705,33197,28947,28947,22116,22823,6831,6124,28039.0,,21768.0,,6271.0,,26504,26504,20028,20343,6476,6161,2901007
1706,33219,19820,19820,15738,15800,4082,4020,19549.0,,15916.0,,3633.0,,18144,18144,14663,14250,3481,3894,2901106
1707,33235,19755,19755,14915,14865,4840,4890,19364.0,,15407.0,,3957.0,,18348,18348,13626,13189,4722,5159,2901205
1708,33251,10816,10816,7821,7923,2995,2893,10708.0,,8152.0,,2556.0,,10611,10611,7325,7374,3286,3237,2901304
1709,33260,12447,12447,10169,10253,2278,2194,12044.0,,10256.0,,1788.0,,11618,11618,9456,9479,2162,2139,2901353
1710,33278,12917,12917,10173,10191,2744,2726,12612.0,,10456.0,,2156.0,,12408,12408,9735,9629,2673,2779,2901403
1711,33294,9364,9364,7461,7454,1903,1910,9189.0,,7782.0,,1407.0,,8831,8831,6976,6738,1855,2093,2901502
1712,33316,11018,11018,8495,8626,2523,2392,10944.0,,9099.0,,1845.0,,10608,10608,8064,7624,2544,2984,2901601
1713,33332,11288,11288,9515,9581,1773,1707,10906.0,,9470.0,,1436.0,,10724,10724,9307,9205,1417,1519,2901700
1714,33359,8833,8833,6787,6810,2046,2023,8793.0,,7381.0,,1412.0,,8196,8196,6201,6123,1995,2073,2901809
1715,33375,14330,14330,10524,10661,3806,3669,14058.0,,10884.0,,3174.0,,13237,13237,9151,9160,4086,4077,2901908
1716,33383,10168,10168,8070,8171,2098,1997,9920.0,,8629.0,,1291.0,,9206,9206,7662,7644,1544,1562,2902054
1717,33391,11997,11997,10266,10284,1731,1713,11409.0,,10543.0,,866.0,,10999,10999,9571,9374,1428,1625,2902005
1718,33405,5988,5988,4730,4748,1258,1240,5690.0,,4894.0,,796.0,,5182,5182,4304,4298,878,884,2901957
1719,33413,42276,42276,29864,30202,12412,12074,41475.0,,31001.0,,10474.0,,39968,39968,27395,27356,12573,12612,2902104
1720,33430,9308,9308,7464,7385,1844,1923,9150.0,,7780.0,,1370.0,,8562,8562,7096,6971,1466,1591,2902203
1721,33456,8596,8596,6642,6682,1954,1914,8450.0,,7076.0,,1374.0,,7854,7854,5853,5861,2001,1993,2902302
1722,33472,9845,9845,7319,7232,2526,2613,9590.0,,7797.0,,1793.0,,9259,9259,7064,6836,2195,2423,2902401
1723,33499,12329,12329,9781,9604,2548,2725,11972.0,,10207.0,,1765.0,,11582,11582,9016,8763,2566,2819,2902500
1724,33510,16187,16187,11664,11744,4523,4443,16027.0,,12522.0,,3505.0,,15520,15520,11035,10909,4485,4611,2902609
1725,33529,10256,10256,8307,8298,1949,1958,9579.0,,8207.0,,1372.0,,9196,9196,7776,7743,1420,1453,2902658
1726,33537,38721,38721,28031,28065,10690,10656,37679.0,,29132.0,,8547.0,,35732,35732,25948,25370,9784,10362,2902708
1727,33553,20103,20103,16841,16915,3262,3188,19844.0,,16949.0,,2895.0,,18854,18854,15166,14766,3688,4088,2902807
1728,33570,29589,29589,22351,22639,7238,6950,28575.0,,22090.0,,6485.0,,28301,28301,20711,20707,7590,7594,2902906
1729,33596,12846,12846,9918,9940,2928,2906,12410.0,,9968.0,,2442.0,,12320,12320,8817,8894,3503,3426,2903003
1730,33618,4208,4208,3073,3073,1135,1135,4181.0,,3468.0,,713.0,,3881,3881,2818,2760,1063,1121,2903102
1731,33634,103075,103075,84618,86565,18457,16510,96559.0,,77987.0,,18572.0,,92210,92210,77790,78687,14420,13523,2903201
1732,33650,6108,6108,4544,4480,1564,1628,6221.0,,5153.0,,1068.0,,5838,5838,4284,4141,1554,1697,2903300
1733,33677,16150,16150,11744,11564,4406,4586,16042.0,,12861.0,,3181.0,,15271,15271,11083,10787,4188,4484,2903409
1734,33693,16477,16477,12208,12349,4269,4128,16140.0,,12903.0,,3237.0,,14897,14897,10529,10161,4368,4736,2903508
1735,33715,12542,12542,10019,9980,2523,2562,12096.0,,10348.0,,1748.0,,11677,11677,10074,9912,1603,1765,2903607
1736,33731,14012,14012,9112,9160,4900,4852,13861.0,,9799.0,,4062.0,,13014,13014,8178,8052,4836,4962,2903706
1737,33758,14570,14570,11051,11065,3519,3505,14409.0,,11764.0,,2645.0,,13318,13318,9909,9609,3409,3709,2903805
1738,33774,50194,50194,38307,38533,11887,11661,48663.0,,37936.0,,10727.0,,45619,45619,33537,32971,12082,12648,2903904
1739,33782,9658,9658,6807,6828,2851,2830,9629.0,,7546.0,,2083.0,,9004,9004,6140,5837,2864,3167,2903953
1740,33790,11206,11206,8296,8365,2910,2841,11020.0,,8562.0,,2458.0,,10434,10434,7324,7312,3110,3122,2904001
1741,33804,12964,12964,9815,9824,3149,3140,12928.0,,10631.0,,2297.0,,12237,12237,9238,9072,2999,3165,2904050
1742,33812,17163,17163,12497,12803,4666,4360,16862.0,,13474.0,,3388.0,,16094,16094,11369,11495,4725,4599,2904100
1743,33839,9988,9988,7230,7326,2758,2662,9888.0,,8306.0,,1582.0,,9726,9726,6733,6726,2993,3000,2904209
1744,33855,11695,11695,8485,8444,3210,3251,11553.0,,8893.0,,2660.0,,11047,11047,7560,7329,3487,3718,2904308
1745,33871,8469,8469,6340,6267,2129,2202,8438.0,,7560.0,,878.0,,7987,7987,5565,5487,2422,2500,2904407
1746,33898,9566,9566,7331,7385,2235,2181,9371.0,,7682.0,,1689.0,,9021,9021,6614,6607,2407,2414,2904506
1747,33910,51226,51226,43345,43890,7881,7336,49108.0,,40693.0,,8415.0,,47738,47738,41492,41323,6246,6415,2904605
1748,33936,12944,12944,9668,9544,3276,3400,12612.0,,9966.0,,2646.0,,12220,12220,9263,9246,2957,2974,2904704
1749,33952,6548,6548,4690,4653,1858,1895,6457.0,,4944.0,,1513.0,,7910,7910,5237,4928,2673,2982,2904803
1750,33960,13452,13452,10685,10759,2767,2693,12843.0,,10934.0,,1909.0,,11947,11947,9617,9578,2330,2369,2904852
1751,33979,26406,26406,20501,20457,5905,5949,25606.0,,20159.0,,5447.0,,25111,25111,19614,18934,5497,6177,2904902
1752,33995,18044,18044,14561,14682,3483,3362,17667.0,,15075.0,,2592.0,,16778,16778,13026,12995,3752,3783,2905008
1753,34010,8004,8004,6248,6337,1756,1667,7805.0,,6648.0,,1157.0,,7322,7322,5835,5913,1487,1409,2905107
1754,34029,10634,10634,7858,8003,2776,2631,10281.0,,8073.0,,2208.0,,9650,9650,6985,6820,2665,2830,2905156
1755,34037,42249,42249,34660,35389,7589,6860,41125.0,,34447.0,,6678.0,,39487,39487,31187,31264,8300,8223,2905206
1756,34053,14897,14897,11409,11547,3488,3350,14584.0,,12139.0,,2445.0,,13395,13395,10136,9969,3259,3426,2905305
1757,34070,13973,13973,11190,11014,2783,2959,13158.0,,11377.0,,1781.0,,12534,12534,10393,9743,2141,2791,2905404
1758,34096,10785,10785,7874,8176,2911,2609,10538.0,,8592.0,,1946.0,,9708,9708,7160,7027,2548,2681,2905503
1759,34118,18704,18704,13840,13737,4864,4967,18687.0,,14396.0,,4291.0,,17801,17801,12820,12594,4981,5207,2905602
1760,34134,191507,191507,158540,161124,32967,30383,179126.0,,146181.0,,32945.0,,165405,165405,143190,145051,22215,20354,2905701
1761,34150,26794,26794,18481,18324,8313,8470,26101.0,,19299.0,,6802.0,,24810,24810,16682,16451,8128,8359,2905800
1762,34177,25262,25262,17974,18175,7288,7087,24963.0,,19431.0,,5532.0,,22097,22097,15307,15213,6790,6884,2905909
1763,34193,57421,57421,45567,45345,11854,12076,55736.0,,46696.0,,9040.0,,52924,52924,41477,40090,11447,12834,2906006
1764,34215,8897,8897,6904,6907,1993,1990,8694.0,,7355.0,,1339.0,,8340,8340,6222,6220,2118,2120,2906105
1765,34231,20216,20216,15838,16227,4378,3989,19664.0,,16316.0,,3348.0,,18136,18136,14217,13939,3919,4197,2906204
1766,34258,24986,24986,18271,18351,6715,6635,24100.0,,18337.0,,5763.0,,23053,23053,17192,17092,5861,5961,2906303
1767,34274,7717,7717,6335,6248,1382,1469,7594.0,,6584.0,,1010.0,,7212,7212,5978,5769,1234,1443,2906402
1768,34290,66298,66298,53156,53785,13142,12513,64674.0,,53159.0,,11515.0,,62371,62371,51412,50645,10959,11726,2906501
1769,34312,10956,10956,8934,9131,2022,1825,10644.0,,8970.0,,1674.0,,10415,10415,8714,8799,1701,1616,2906600
1770,34339,20166,20166,15456,15504,4710,4662,19117.0,,15638.0,,3479.0,,18046,18046,13885,13736,4161,4310,2906709
1771,34355,30099,30099,22972,23224,7127,6875,29317.0,,23517.0,,5800.0,,27044,27044,19554,19590,7490,7454,2906808
1772,34363,8980,8980,6598,6621,2382,2359,8896.0,,7202.0,,1694.0,,8358,8358,6017,5835,2341,2523,2906899
1773,34371,16459,16459,12173,12142,4286,4317,15938.0,,12893.0,,3045.0,,13942,13942,10241,9842,3701,4100,2906907
1774,34398,7980,7980,5808,5755,2172,2225,7688.0,,6119.0,,1569.0,,7294,7294,5240,5239,2054,2055,2907004
1775,34410,23281,23281,17609,17739,5672,5542,22849.0,,18284.0,,4565.0,,21566,21566,15449,15307,6117,6259,2907103
1776,34436,56798,56798,46102,46387,10696,10411,54997.0,,46614.0,,8383.0,,51739,51739,41582,40815,10157,10924,2907202
1777,34452,23116,23116,18087,18034,5029,5082,22711.0,,18098.0,,4613.0,,22336,22336,16734,16237,5602,6099,2907301
1778,34479,3948,3948,3235,3219,713,729,4021.0,,3703.0,,318.0,,3510,3510,2795,2751,715,759,2907400
1779,34495,41949,41949,33470,34050,8479,7899,40768.0,,32835.0,,7933.0,,40272,40272,32743,32551,7529,7721,2907509
1780,34509,7701,7701,5744,5804,1957,1897,7794.0,,6550.0,,1244.0,,7573,7573,5411,5389,2162,2184,2907558
1781,34517,13816,13816,10852,10906,2964,2910,13459.0,,11137.0,,2322.0,,13145,13145,10059,10012,3086,3133,2907608
1782,34533,9255,9255,7056,6860,2199,2395,9151.0,,7708.0,,1443.0,,8944,8944,6719,6419,2225,2525,2907707
1783,34550,26838,26838,20293,20605,6545,6233,26148.0,,20853.0,,5295.0,,25291,25291,18794,18910,6497,6381,2907806
1784,34576,14412,14412,10746,10708,3666,3704,14167.0,,11331.0,,2836.0,,13354,13354,9867,9542,3487,3812,2907905
1785,34592,16929,16929,12108,12069,4821,4860,16876.0,,12578.0,,4298.0,,16754,16754,11716,11650,5038,5104,2908002
1786,34614,15759,15759,12146,12243,3613,3516,15427.0,,13057.0,,2370.0,,14603,14603,11434,11470,3169,3133,2908101
1787,34630,17596,17596,14365,14441,3231,3155,16890.0,,14235.0,,2655.0,,16648,16648,13907,13683,2741,2965,2908200
1788,34657,15352,15352,12141,12261,3211,3091,15058.0,,12307.0,,2751.0,,14381,14381,11107,10891,3274,3490,2908309
1789,34673,54410,54410,44375,44928,10035,9482,53074.0,,45436.0,,7638.0,,50870,50870,41070,40450,9800,10420,2908408
1790,34690,26796,26796,21636,22231,5160,4565,25509.0,,21022.0,,4487.0,,23825,23825,19398,19228,4427,4597,2908507
1791,34711,19266,19266,14271,14377,4995,4889,18839.0,,15063.0,,3776.0,,17300,17300,12677,12371,4623,4929,2908606
1792,34738,15946,15946,11357,11614,4589,4332,15678.0,,11847.0,,3831.0,,15360,15360,10396,10520,4964,4840,2908705
1793,34754,4312,4312,3461,3424,851,888,4145.0,,3674.0,,471.0,,3793,3793,3048,2852,745,941,2908804
1794,34770,22309,22309,17686,17854,4623,4455,21415.0,,16761.0,,4654.0,,20971,20971,16401,16112,4570,4859,2908903
1795,34797,7390,7390,5251,5261,2139,2129,7366.0,,5818.0,,1548.0,,6985,6985,4759,4858,2226,2127,2909000
1796,34819,12469,12469,9670,9596,2799,2873,12185.0,,10205.0,,1980.0,,11782,11782,8962,8777,2820,3005,2909109
1797,34835,13889,13889,11378,11406,2511,2483,13348.0,,12260.0,,1088.0,,11513,11513,9991,9768,1522,1745,2909208
1798,34851,28188,28188,20928,21039,7260,7149,27626.0,,22035.0,,5591.0,,26351,26351,18836,18689,7515,7662,2909307
1799,34878,11962,11962,9022,9064,2940,2898,11877.0,,9923.0,,1954.0,,11208,11208,8196,7852,3012,3356,2909406
1800,34894,4390,4390,3183,3173,1207,1217,4381.0,,3468.0,,913.0,,4243,4243,3007,2938,1236,1305,2909505
1801,34916,17827,17827,12305,12721,5522,5106,17593.0,,13263.0,,4330.0,,16845,16845,11445,11467,5400,5378,2909604
1802,34932,12588,12588,9634,9706,2954,2882,12288.0,,10392.0,,1896.0,,11801,11801,8882,8639,2919,3162,2909703
1803,34959,47625,47625,40333,41082,7292,6543,45487.0,,38361.0,,7126.0,,44071,44071,38635,38918,5436,5153,2909802
1804,34975,26623,26623,20905,21058,5718,5565,25761.0,,21416.0,,4345.0,,25044,25044,18990,18692,6054,6352,2909901
1805,34991,8051,8051,6040,6013,2011,2038,7764.0,,6344.0,,1420.0,,7550,7550,5749,5573,1801,1977,2910008
1806,35017,10526,10526,8784,8935,1742,1591,10345.0,,9109.0,,1236.0,,9808,9808,7794,7945,2014,1863,2910107
1807,35033,4394,4394,3678,3709,716,685,4132.0,,3709.0,,423.0,,3892,3892,3284,3141,608,751,2910206
1808,35050,7868,7868,5919,5977,1949,1891,7782.0,,6329.0,,1453.0,,7475,7475,5385,5082,2090,2393,2910305
1809,35076,15409,15409,11720,11776,3689,3633,15199.0,,12507.0,,2692.0,,14389,14389,10778,10762,3611,3627,2910404
1810,35092,33211,33211,23893,23859,9318,9352,32516.0,,24013.0,,8503.0,,31948,31948,23098,22775,8850,9173,2910503
1811,35114,26970,26970,20688,20795,6282,6175,26305.0,,21518.0,,4787.0,,24806,24806,18778,18443,6028,6363,2910602
1812,35130,47234,47234,36128,36537,11106,10697,45392.0,,36522.0,,8870.0,,42685,42685,31966,31698,10719,10987,2910701
1813,35149,5467,5467,4140,4144,1327,1323,5440.0,,4657.0,,783.0,,4997,4997,3574,3484,1423,1513,2910776
1814,35157,424521,424521,360349,366603,64172,57918,400549.0,400549.0,323990.0,325145.0,76559.0,75404.0,384050,384050,342242,342514,41808,41536,2910800
1815,35173,5327,5327,3829,3792,1498,1535,5202.0,,4311.0,,891.0,,4818,4818,3423,3334,1395,1484,2910909
1816,35190,8263,8263,6077,6059,2186,2204,8300.0,,6486.0,,1814.0,,7593,7593,5443,5364,2150,2229,2911006
1817,35211,19980,19980,15393,15634,4587,4346,19549.0,,16677.0,,2872.0,,18315,18315,13321,12875,4994,5440,2911105
1818,35238,23467,23467,18426,18377,5041,5090,22831.0,,18624.0,,4207.0,,21700,21700,16532,16349,5168,5351,2911204
1819,35254,9606,9606,7823,7800,1783,1806,9451.0,,8356.0,,1095.0,,8962,8962,6958,6930,2004,2032,2911303
1820,35270,13617,13617,10286,10374,3331,3243,13319.0,,10579.0,,2740.0,,12782,12782,9906,9961,2876,2821,2911402
1821,35297,5298,5298,3777,3760,1521,1538,5168.0,,4023.0,,1145.0,,4948,4948,3421,3354,1527,1594,2911501
1822,35319,17816,17816,14152,14377,3664,3439,16974.0,,14088.0,,2886.0,,15836,15836,12656,12795,3180,3041,2911600
1823,35335,64990,64990,54760,55552,10230,9438,62147.0,,52644.0,,9503.0,,60392,60392,51718,51727,8674,8665,2911709
1824,35351,16007,16007,11528,11432,4479,4575,15939.0,,12485.0,,3454.0,,14871,14871,10627,10307,4244,4564,2911808
1825,35378,22287,22287,14991,15103,7296,7184,21923.0,,15496.0,,6427.0,,22082,22082,14415,14327,7667,7755,2911907
1826,35394,8946,8946,6933,7066,2013,1880,8865.0,,7227.0,,1638.0,,8781,8781,6430,6441,2351,2340,2912004
1827,35416,19397,19397,14465,14530,4932,4867,19203.0,,14984.0,,4219.0,,18514,18514,13339,13171,5175,5343,2912103
1828,35432,15289,15289,12475,12533,2814,2756,14977.0,,13043.0,,1934.0,,13144,13144,10177,10053,2967,3091,2912202
1829,35459,12020,12020,9096,9175,2924,2845,11808.0,,9616.0,,2192.0,,10975,10975,7828,7660,3147,3315,2912301
1830,35475,13848,13848,11042,11162,2806,2686,13584.0,,11495.0,,2089.0,,13376,13376,10142,10090,3234,3286,2912400
1831,35491,23558,23558,17413,17319,6145,6239,23128.0,,18938.0,,4190.0,,22499,22499,15915,15420,6584,7079,2928406
1832,35513,13488,13488,9659,9657,3829,3831,13342.0,,10556.0,,2786.0,,12703,12703,8787,8519,3916,4184,2912509
1833,35530,3992,3992,3041,2895,951,1097,3810.0,,3256.0,,554.0,,3416,3416,2391,2199,1025,1217,2912608
1834,35556,13760,13760,10452,10389,3308,3371,13613.0,,11376.0,,2237.0,,12638,12638,10350,10346,2288,2292,2912707
1835,35572,7563,7563,5889,5970,1674,1593,7284.0,,5993.0,,1291.0,,6788,6788,5061,4936,1727,1852,2912806
1836,35599,15476,15476,11549,11642,3927,3834,15051.0,,11907.0,,3144.0,,14538,14538,11039,11007,3499,3531,2912905
1837,35610,11503,11503,9170,9165,2333,2338,11100.0,,9691.0,,1409.0,,10479,10479,8693,8622,1786,1857,2913002
1838,35637,15321,15321,12666,12584,2655,2737,15119.0,,13408.0,,1711.0,,14224,14224,11100,11001,3124,3223,2913101
1839,35653,21308,21308,16555,16535,4753,4773,20511.0,,16756.0,,3755.0,,19636,19636,14850,14447,4786,5189,2913200
1840,35670,5863,5863,4914,4934,949,929,5700.0,,5153.0,,547.0,,5261,5261,4423,4344,838,917,2913309
1841,35696,12291,12291,10118,10305,2173,1986,11980.0,,10573.0,,1407.0,,11652,11652,9408,9368,2244,2284,2913408
1842,35700,10117,10117,6838,6681,3279,3436,10145.0,,7397.0,,2748.0,,9858,9858,6616,6470,3242,3388,2913457
1843,35718,20251,20251,13812,14163,6439,6088,20406.0,,15077.0,,5329.0,,19697,19697,12731,12589,6966,7108,2913507
1844,35734,128420,128420,103805,104301,24615,24119,122636.0,,96291.0,,26345.0,,116780,116780,98452,98810,18328,17970,2913606
1845,35750,28089,28089,21239,21705,6850,6384,27074.0,,21198.0,,5876.0,,25865,25865,19238,19328,6627,6537,2913705
1846,35777,14151,14151,11447,11360,2704,2791,13790.0,,11732.0,,2058.0,,13249,13249,10792,10459,2457,2790,2913804
1847,35793,31800,31800,24892,25039,6908,6761,30559.0,,24001.0,,6558.0,,29891,29891,22937,23127,6954,6764,2913903
1848,35815,46754,46754,37027,37288,9727,9466,44808.0,,36939.0,,7869.0,,43574,43574,35532,35424,8042,8150,2914000
1849,35831,8604,8604,6802,6905,1802,1699,8392.0,,7030.0,,1362.0,,7804,7804,5964,5922,1840,1882,2914109
1850,35858,5396,5396,4146,4145,1250,1251,5152.0,,4365.0,,787.0,,5049,5049,3959,3937,1090,1112,2914208
1851,35874,9183,9183,6712,6722,2471,2461,9129.0,,7300.0,,1829.0,,8699,8699,6018,5747,2681,2952,2914307
1852,35890,18617,18617,15101,15321,3516,3296,17955.0,,14933.0,,3022.0,,16623,16623,13063,13257,3560,3366,2914406
1853,35912,25627,25627,19529,19624,6098,6003,24601.0,,19480.0,,5121.0,,23482,23482,17655,17388,5827,6094,2914505
1854,35939,48833,48833,41027,41413,7806,7420,45822.0,,38814.0,,7008.0,,44082,44082,37639,37581,6443,6501,2914604
1855,35947,24266,24266,16759,16786,7507,7480,23970.0,,17963.0,,6007.0,,22432,22432,15587,15438,6845,6994,2914653
1856,35955,48894,48894,39507,39775,9387,9119,47246.0,,38849.0,,8397.0,,42346,42346,33165,32756,9181,9590,2914703
1857,35971,156529,156529,117673,118170,38856,38359,154369.0,,110744.0,,43625.0,,154473,154473,115118,114011,39355,40462,2914802
1858,35998,18613,18613,14080,14180,4533,4433,17140.0,,13504.0,,3636.0,,15122,15122,10750,10714,4372,4408,2914901
1859,36013,11436,11436,8261,8345,3175,3091,11081.0,,8918.0,,2163.0,,10713,10713,7625,7513,3088,3200,2915007
1860,36030,10263,10263,7611,7702,2652,2561,9927.0,,7966.0,,1961.0,,9546,9546,7390,7380,2156,2166,2915106
1861,36056,12140,12140,9253,9257,2887,2883,11408.0,,9125.0,,2283.0,,11041,11041,8210,8134,2831,2907,2915205
1862,36072,6131,6131,4499,4362,1632,1769,6021.0,,4980.0,,1041.0,,5696,5696,4487,4284,1209,1412,2915304
1863,36080,10868,10868,8360,8328,2508,2540,10555.0,,8962.0,,1593.0,,9654,9654,7234,7046,2420,2608,2915353
1864,36099,5518,5518,4080,3951,1438,1567,5374.0,,4340.0,,1034.0,,5102,5102,3672,3370,1430,1732,2915403
1865,36110,17692,17692,13014,12945,4678,4747,17467.0,,13289.0,,4178.0,,17003,17003,12252,12057,4751,4946,2915502
1866,36137,47640,47640,35646,35750,11994,11890,46954.0,,36665.0,,10289.0,,44327,44327,32477,31945,11850,12382,2915601
1867,36153,6674,6674,4823,4809,1851,1865,6587.0,,5099.0,,1488.0,,6440,6440,4625,4436,1815,2004,2915700
1868,36170,20056,20056,14548,14545,5508,5511,20074.0,,15289.0,,4785.0,,18243,18243,12513,12107,5730,6136,2915809
1869,36196,6327,6327,4643,4631,1684,1696,6051.0,,4962.0,,1089.0,,5587,5587,4149,3923,1438,1664,2915908
1870,36218,16440,16440,11445,11567,4995,4873,16231.0,,12306.0,,3925.0,,15910,15910,10789,10891,5121,5019,2916005
1871,36234,18363,18363,14839,14963,3524,3400,17579.0,,14692.0,,2887.0,,16599,16599,13753,13596,2846,3003,2916104
1872,36250,9387,9387,6627,6608,2760,2779,9386.0,,7050.0,,2336.0,,9547,9547,6641,6561,2906,2986,2916203
1873,36277,8105,8105,5886,5801,2219,2304,8015.0,,6595.0,,1420.0,,7366,7366,5802,5612,1564,1754,2916302
1874,36293,49897,49897,38782,38957,11115,10940,48438.0,,37404.0,,11034.0,,46558,46558,35139,34690,11419,11868,2916401
1875,36315,24950,24950,17898,18236,7052,6714,24339.0,,18199.0,,6140.0,,23259,23259,15925,16036,7334,7223,2916500
1876,36331,6770,6770,4676,4691,2094,2079,6815.0,,5072.0,,1743.0,,6576,6576,4274,4136,2302,2440,2916609
1877,36358,6528,6528,4964,5034,1564,1494,6410.0,,5531.0,,879.0,,6172,6172,4724,4740,1448,1432,2916708
1878,36374,14442,14442,10778,10706,3664,3736,14150.0,,11189.0,,2961.0,,14170,14170,10196,9768,3974,4402,2916807
1879,36382,12891,12891,10103,10270,2788,2621,12579.0,,10792.0,,1787.0,,11573,11573,9063,8694,2510,2879,2916856
1880,36390,9687,9687,7231,7268,2456,2419,9458.0,,7281.0,,2177.0,,9312,9312,6531,6557,2781,2755,2916906
1881,36412,30043,30043,21773,21824,8270,8219,29355.0,,22602.0,,6753.0,,29225,29225,20331,19868,8894,9357,2917003
1882,36439,17407,17407,12615,12586,4792,4821,17349.0,,13252.0,,4097.0,,16484,16484,11373,11083,5111,5401,2917102
1883,36455,15565,15565,12532,12723,3033,2842,15194.0,,12837.0,,2357.0,,14599,14599,11426,11493,3173,3106,2917201
1884,36471,19716,19716,13659,13401,6057,6315,19563.0,,14237.0,,5326.0,,19258,19258,13271,13092,5987,6166,2917300
1885,36498,12073,12073,8874,9050,3199,3023,11924.0,,8861.0,,3063.0,,12001,12001,8433,8379,3568,3622,2917409
1886,36510,59585,59585,48080,48490,11505,11095,56261.0,,45879.0,,10382.0,,53609,53609,44794,44766,8815,8843,2917508
1887,36536,34655,34655,26867,27417,7788,7238,33127.0,,26424.0,,6703.0,,32615,32615,25252,25587,7363,7028,2917607
1888,36552,22039,22039,17613,17732,4426,4307,21920.0,,18334.0,,3586.0,,22098,22098,17206,17289,4892,4809,2917706
1889,36579,15223,15223,11951,11913,3272,3310,14976.0,,12622.0,,2354.0,,13039,13039,10195,10005,2844,3034,2917805
1890,36595,9182,9182,6526,6442,2656,2740,9242.0,,7583.0,,1659.0,,8250,8250,5857,5532,2393,2718,2917904
1891,36617,114760,114760,93901,95111,20859,19649,108875.0,,88678.0,,20197.0,,105277,105277,90398,90021,14879,15256,2918001
1892,36633,28996,28996,22679,22940,6317,6056,28465.0,,23897.0,,4568.0,,26738,26738,19839,19835,6899,6903,2918100
1893,36650,11597,11597,8763,8820,2834,2777,11377.0,,8943.0,,2434.0,,10702,10702,7878,7641,2824,3061,2918209
1894,36676,12194,12194,9559,9501,2635,2693,11467.0,,9225.0,,2242.0,,11107,11107,8803,8565,2304,2542,2918308
1895,36692,156048,156048,130414,131600,25634,24448,146909.0,,123223.0,,23686.0,,140481,140481,121854,122505,18627,17976,2918407
1896,36706,8734,8734,6491,6476,2243,2258,8646.0,,7136.0,,1510.0,,7960,7960,5717,5418,2243,2542,2918456
1897,36714,13601,13601,10574,10780,3027,2821,13133.0,,11285.0,,1848.0,,12144,12144,9065,9021,3079,3123,2918506
1898,36730,6834,6834,5354,5426,1480,1408,6832.0,,5817.0,,1015.0,,6675,6675,4958,4841,1717,1834,2918605
1899,36757,3913,3913,3355,3337,558,576,3746.0,,3337.0,,409.0,,3532,3532,3077,2959,455,573,2918704
1900,36765,10645,10645,8368,8626,2277,2019,10562.0,,9106.0,,1456.0,,10471,10471,7729,7825,2742,2646,2918803
1901,36773,20497,20497,15780,16252,4717,4245,20200.0,,16427.0,,3773.0,,19038,19038,14635,14461,4403,4577,2918902
1902,36790,4787,4787,3329,3334,1458,1453,4909.0,,4076.0,,833.0,,4821,4821,3329,3068,1492,1753,2919009
1903,36811,3584,3584,2794,2769,790,815,3505.0,,2957.0,,548.0,,3235,3235,2487,2385,748,850,2919058
1904,36820,6552,6552,4971,5059,1581,1493,6480.0,,5125.0,,1355.0,,6217,6217,4574,4558,1643,1659,2918753
1905,36838,8482,8482,6013,5938,2469,2544,8334.0,,6384.0,,1950.0,,7887,7887,5368,5105,2519,2782,2919108
1906,36854,156597,156597,123099,126802,33498,29795,145205.0,,111003.0,,34202.0,,129108,129108,104516,104232,24592,24876,2919207
1907,36870,8223,8223,6268,6325,1955,1898,7988.0,,6372.0,,1616.0,,7602,7602,5438,5394,2164,2208,2919306
1908,36897,9907,9907,7864,7963,2043,1944,9840.0,,8058.0,,1782.0,,9280,9280,7235,7252,2045,2028,2919405
1909,36919,35421,35421,28283,28814,7138,6607,34722.0,,28462.0,,6260.0,,33571,33571,25343,25533,8228,8038,2919504
1910,36935,10475,10475,7355,7304,3120,3171,10268.0,,8059.0,,2209.0,,9772,9772,6410,6267,3362,3505,2919603
1911,36951,13856,13856,9775,9912,4081,3944,13917.0,,10667.0,,3250.0,,13752,13752,9345,9245,4407,4507,2919702
1912,36978,34869,34869,25687,26174,9182,8695,33940.0,,25861.0,,8079.0,,33800,33800,23522,23230,10278,10570,2919801
1913,36994,6855,6855,5262,5084,1593,1771,6649.0,,5407.0,,1242.0,,6529,6529,4732,4451,1797,2078,2919900
1914,37010,7727,7727,5765,5782,1962,1945,7707.0,,6311.0,,1396.0,,7287,7287,5227,5169,2060,2118,2920007
1915,37036,14607,14607,10708,10846,3899,3761,14281.0,,11091.0,,3190.0,,14362,14362,9972,9866,4390,4496,2920106
1916,37052,14017,14017,10566,10565,3451,3452,13858.0,,11468.0,,2390.0,,13034,13034,9458,9198,3576,3836,2920205
1917,37079,7505,7505,6285,6314,1220,1191,7226.0,,6607.0,,619.0,,6726,6726,5684,5621,1042,1105,2920304
1918,37095,12662,12662,9950,9898,2712,2764,12276.0,,10197.0,,2079.0,,11619,11619,9546,9163,2073,2456,2920403
1919,37117,22204,22204,16360,16609,5844,5595,21605.0,,16242.0,,5363.0,,21458,21458,15013,14872,6445,6586,2920502
1920,37133,35052,35052,27861,28043,7191,7009,34003.0,,27788.0,,6215.0,,32575,32575,25231,24717,7344,7858,2920601
1921,37150,15285,15285,11160,11117,4125,4168,14828.0,,11739.0,,3089.0,,12936,12936,8941,8810,3995,4126,2920700
1922,37176,7897,7897,5773,5749,2124,2148,7769.0,,6085.0,,1684.0,,7703,7703,5422,5320,2281,2383,2920809
1923,37192,10028,10028,6930,6844,3098,3184,9981.0,,7713.0,,2268.0,,9028,9028,6203,5964,2825,3064,2920908
1924,37214,42183,42183,32528,32881,9655,9302,40945.0,,32344.0,,8601.0,,39638,39638,31366,30914,8272,8724,2921005
1925,37222,9670,9670,7625,7793,2045,1877,9402.0,,8134.0,,1268.0,,8987,8987,6828,6798,2159,2189,2921054
1926,37230,19414,19414,14632,14667,4782,4747,18705.0,,14769.0,,3936.0,,18442,18442,13307,12951,5135,5491,2921104
1927,37257,22003,22003,16125,16116,5878,5887,21672.0,,16235.0,,5437.0,,21540,21540,15169,14827,6371,6713,2921203
1928,37273,9286,9286,7171,7095,2115,2191,9378.0,,7666.0,,1712.0,,8656,8656,6477,6240,2179,2416,2921302
1929,37290,11847,11847,9745,9612,2102,2235,11188.0,,9755.0,,1433.0,,10734,10734,8907,8788,1827,1946,2921401
1930,37303,8267,8267,6121,6143,2146,2124,7963.0,,6406.0,,1557.0,,7529,7529,5325,5130,2204,2399,2921450
1931,37311,44796,44796,32516,32816,12280,11980,44109.0,,33987.0,,10122.0,,43120,43120,30199,29797,12921,13323,2921500
1932,37338,7884,7884,5940,5960,1944,1924,7628.0,,6249.0,,1379.0,,7215,7215,5204,5131,2011,2084,2921609
1933,37354,26248,26248,20556,20470,5692,5778,25227.0,,20292.0,,4935.0,,24025,24025,18393,18097,5632,5928,2921708
1934,37370,9762,9762,7061,7192,2701,2570,9644.0,,7481.0,,2163.0,,9522,9522,6752,6653,2770,2869,2921807
1935,37397,9729,9729,7921,7966,1808,1763,9546.0,,8186.0,,1360.0,,8859,8859,6876,6778,1983,2081,2921906
1936,37419,30549,30549,21308,21333,9241,9216,30835.0,,23483.0,,7352.0,,27885,27885,18788,18061,9097,9824,2922003
1937,37427,11160,11160,8584,8591,2576,2569,10736.0,,8732.0,,2004.0,,10529,10529,7859,7830,2670,2699,2922052
1938,37435,16096,16096,11575,11739,4521,4357,15771.0,,12168.0,,3603.0,,15509,15509,10822,10524,4687,4985,2922102
1939,37451,7655,7655,6504,6525,1151,1130,7379.0,,6663.0,,716.0,,6932,6932,5893,5799,1039,1133,2922201
1940,37460,9714,9714,7418,7337,2296,2377,9577.0,,8131.0,,1446.0,,8963,8963,6637,6292,2326,2671,2922250
1941,37478,23148,23148,18126,18318,5022,4830,22356.0,,17916.0,,4440.0,,21104,21104,17239,17138,3865,3966,2922300
1942,37494,19048,19048,14118,14457,4930,4591,18672.0,,14053.0,,4619.0,,18024,18024,13120,13068,4904,4956,2922409
1943,37516,22471,22471,17876,17965,4595,4506,21960.0,,17810.0,,4150.0,,21443,21443,16855,16621,4588,4822,2922508
1944,37532,9741,9741,7571,7530,2170,2211,9562.0,,8126.0,,1436.0,,8854,8854,6766,6627,2088,2227,2922607
1945,37559,13232,13232,9350,9546,3882,3686,12977.0,,9908.0,,3069.0,,12194,12194,8122,8022,4072,4172,2922706
1946,37567,7776,7776,6185,6137,1591,1639,7625.0,,6659.0,,966.0,,7216,7216,5712,5516,1504,1700,2922730
1947,37575,6585,6585,5050,5085,1535,1500,6429.0,,5183.0,,1246.0,,5648,5648,4203,4090,1445,1558,2922805
1948,37583,6566,6566,4926,5018,1640,1548,6393.0,,5303.0,,1090.0,,6157,6157,4577,4508,1580,1649,2922854
1949,37591,21686,21686,15982,16180,5704,5506,21299.0,,16476.0,,4823.0,,20200,20200,14520,14568,5680,5632,2922904
1950,37613,32331,32331,23311,23305,9020,9026,31982.0,,24348.0,,7634.0,,29064,29064,20325,19854,8739,9210,2923001
1951,37621,8706,8706,6241,6233,2465,2473,8377.0,,6659.0,,1718.0,,8047,8047,5366,5182,2681,2865,2923050
1952,37630,21036,21036,14969,15042,6067,5994,20573.0,,15155.0,,5418.0,,20131,20131,13691,13471,6440,6660,2923100
1953,37656,17139,17139,13071,13242,4068,3897,16908.0,,13980.0,,2928.0,,16557,16557,12170,12186,4387,4371,2923209
1954,37672,7248,7248,5470,5412,1778,1836,7097.0,,5616.0,,1481.0,,6772,6772,4971,4787,1801,1985,2923308
1955,37680,13359,13359,10923,10933,2436,2426,12335.0,,11090.0,,1245.0,,11892,11892,9963,9897,1929,1995,2923357
1956,37699,17519,17519,13969,14099,3550,3420,17292.0,,14206.0,,3086.0,,17092,17092,13014,13109,4078,3983,2923407
1957,37710,7741,7741,6302,6395,1439,1346,7275.0,,6096.0,,1179.0,,6669,6669,5204,5152,1465,1517,2923506
1958,37737,17424,17424,13391,13613,4033,3811,17318.0,,14508.0,,2810.0,,16399,16399,11686,11754,4713,4645,2923605
1959,37753,24524,24524,18639,18878,5885,5646,23896.0,,19672.0,,4224.0,,22639,22639,16850,16640,5789,5999,2923704
1960,37770,22869,22869,18315,18697,4554,4172,22114.0,,17985.0,,4129.0,,21769,21769,17332,17612,4437,4157,2923803
1961,37796,7928,7928,5863,5899,2065,2029,7961.0,,6353.0,,1608.0,,7209,7209,5266,5107,1943,2102,2923902
1962,37818,87792,87792,65289,65746,22503,22046,84751.0,,63094.0,,21657.0,,81179,81179,60704,60844,20475,20335,2924009
1963,37834,6574,6574,5186,5104,1388,1470,6338.0,,5371.0,,967.0,,5974,5974,4520,4182,1454,1792,2924108
1964,37850,10411,10411,7791,7726,2620,2685,10277.0,,8308.0,,1969.0,,9592,9592,7013,6779,2579,2813,2924207
1965,37877,17527,17527,13022,13214,4505,4313,16916.0,,13262.0,,3654.0,,16459,16459,11732,11598,4727,4861,2924306
1966,37893,28294,28294,21541,21265,6753,7029,27014.0,,22370.0,,4644.0,,25497,25497,19205,18723,6292,6774,2924405
1967,37915,12927,12927,10453,10601,2474,2326,12639.0,,10805.0,,1834.0,,12366,12366,9700,9680,2666,2686,2924504
1968,37931,15836,15836,12530,12441,3306,3395,15341.0,,13007.0,,2334.0,,14745,14745,11073,10822,3672,3923,2924603
1969,37940,6883,6883,5494,5380,1389,1503,6800.0,,5823.0,,977.0,,6303,6303,5062,4935,1241,1368,2924678
1970,37958,9709,9709,6575,6586,3134,3123,9520.0,,7339.0,,2181.0,,9097,9097,5741,5634,3356,3463,2924702
1971,37974,14761,14761,11213,11176,3548,3585,14436.0,,11711.0,,2725.0,,13720,13720,10153,9931,3567,3789,2924801
1972,37990,6957,6957,5418,5371,1539,1586,6751.0,,5778.0,,973.0,,6566,6566,4904,4956,1662,1610,2924900
1973,38016,19971,19971,15621,15788,4350,4183,19575.0,,16079.0,,3496.0,,18732,18732,14596,14462,4136,4270,2925006
1974,38032,38994,38994,28526,28761,10468,10233,38065.0,,28109.0,,9956.0,,35794,35794,24794,24584,11000,11210,2925105
1975,38059,28117,28117,22490,22878,5627,5239,27349.0,,21852.0,,5497.0,,26812,26812,21567,21479,5245,5333,2925204
1976,38067,14716,14716,10501,10600,4215,4116,14309.0,,11127.0,,3182.0,,13184,13184,8889,8921,4295,4263,2925253
1977,38075,104184,104184,80037,81279,24147,22905,96574.0,,76381.0,,20193.0,,88317,88317,72395,73233,15922,15084,2925303
1978,38091,9212,9212,6063,6011,3149,3201,9211.0,,6717.0,,2494.0,,8827,8827,5710,5444,3117,3383,2925402
1979,38113,24656,24656,17809,17847,6847,6809,24010.0,,18371.0,,5639.0,,21414,21414,14589,13980,6825,7434,2925501
1980,38130,11321,11321,9782,9817,1539,1504,10807.0,,9768.0,,1039.0,,10281,10281,8913,8912,1368,1369,2925600
1981,38156,11959,11959,7840,7953,4119,4006,11853.0,,8628.0,,3225.0,,11413,11413,7033,6837,4380,4576,2925709
1982,38164,22059,22059,17037,17266,5022,4793,21234.0,,17233.0,,4001.0,,19770,19770,15126,15022,4644,4748,2925758
1983,38172,21000,21000,15785,15869,5215,5131,20606.0,,16386.0,,4220.0,,19836,19836,14479,14163,5357,5673,2925808
1984,38199,22118,22118,16755,16949,5363,5169,21743.0,,17416.0,,4327.0,,20709,20709,15559,15385,5150,5324,2925907
1985,38210,32583,32583,24891,25285,7692,7298,31763.0,,25383.0,,6380.0,,30249,30249,22242,22591,8007,7658,2926004
1986,38237,12515,12515,10243,10125,2272,2390,12217.0,,10592.0,,1625.0,,11819,11819,9278,9322,2541,2497,2926103
1987,38253,20146,20146,14885,14937,5261,5209,19925.0,,16278.0,,3647.0,,18445,18445,13633,13164,4812,5281,2926202
1988,38270,27483,27483,22935,23142,4548,4341,26704.0,,23036.0,,3668.0,,25886,25886,21358,21270,4528,4616,2926301
1989,38296,24233,24233,18641,19005,5592,5228,23696.0,,19443.0,,4253.0,,23729,23729,17758,17978,5971,5751,2926400
1990,38318,12624,12624,9336,9223,3288,3401,12616.0,,10033.0,,2583.0,,11963,11963,8552,8314,3411,3649,2926509
1991,38334,41920,41920,33919,33992,8001,7928,39428.0,,32809.0,,6619.0,,37638,37638,31235,30959,6403,6679,2926608
1992,38342,8110,8110,6211,6227,1899,1883,7978.0,,6630.0,,1348.0,,7560,7560,5809,5565,1751,1995,2926657
1993,38350,12375,12375,9691,9803,2684,2572,12284.0,,10089.0,,2195.0,,11922,11922,8819,8603,3103,3319,2926707
1994,38377,11526,11526,8544,8677,2982,2849,11458.0,,8990.0,,2468.0,,11229,11229,7787,7866,3442,3363,2926806
1995,38393,10051,10051,6761,6694,3290,3357,10056.0,,7694.0,,2362.0,,10059,10059,6343,6066,3716,3993,2926905
1996,38415,30100,30100,22312,22583,7788,7517,29623.0,,23199.0,,6424.0,,29192,29192,21205,21063,7987,8129,2927002
1997,38431,7378,7378,6088,6000,1290,1378,7116.0,,6289.0,,827.0,,6447,6447,5075,4900,1372,1547,2927101
1998,38458,25127,25127,18334,18367,6793,6760,24772.0,,18502.0,,6270.0,,23789,23789,16329,16232,7460,7557,2927200
1999,38474,14282,14282,11302,11199,2980,3083,13504.0,,11334.0,,2170.0,,11644,11644,9482,9134,2162,2510,2927309
2000,38490,1983198,1983198,1627855,1663866,355343,319332,1897098.0,,1395105.0,,501993.0,,1827436,1827436,1579607,1604639,247829,222797,2927408
2001,38512,19577,19577,15851,15918,3726,3659,18633.0,,15315.0,,3318.0,,17858,17858,14145,13877,3713,3981,2927507
2002,38539,12437,12437,9044,9004,3393,3433,12042.0,,9130.0,,2912.0,,12018,12018,8576,8496,3442,3522,2927606
2003,38555,22279,22279,16568,16600,5711,5679,20700.0,,16560.0,,4140.0,,18037,18037,14282,14202,3755,3835,2927705
2004,38571,5040,5040,3402,3356,1638,1684,5000.0,,3847.0,,1153.0,,4659,4659,2886,2770,1773,1889,2927804
2005,38598,8610,8610,6104,6160,2506,2450,8471.0,,6403.0,,2068.0,,8225,8225,5814,5709,2411,2516,2927903
2006,38610,32184,32184,25172,25459,7012,6725,31539.0,,26334.0,,5205.0,,30082,30082,23008,22479,7074,7603,2928000
2007,38636,31901,31901,24236,24332,7665,7569,31525.0,,25126.0,,6399.0,,29919,29919,21626,21350,8293,8569,2928109
2008,38652,21585,21585,16465,16736,5120,4849,20929.0,,16472.0,,4457.0,,20265,20265,15020,14998,5245,5267,2928208
2009,38679,9312,9312,7267,7156,2045,2156,8937.0,,7496.0,,1441.0,,8389,8389,6357,6080,2032,2309,2928307
2010,38695,9372,9372,7052,6975,2320,2397,9136.0,,7456.0,,1680.0,,8849,8849,6260,6034,2589,2815,2928505
2011,38717,49910,49910,39147,39087,10763,10823,48195.0,,38210.0,,9985.0,,46527,46527,36777,35963,9750,10564,2928604
2012,38733,74781,74781,61359,62643,13422,12138,70531.0,,58644.0,,11887.0,,67597,67597,55814,56385,11783,11212,2928703
2013,38750,37934,37934,31080,31320,6854,6614,36370.0,,29803.0,,6567.0,,35723,35723,29790,29928,5933,5795,2928802
2014,38776,24775,24775,20283,20497,4492,4278,23639.0,,20916.0,,2723.0,,21461,21461,17467,17403,3994,4058,2928901
2015,38792,10692,10692,8456,8406,2236,2286,10620.0,,8643.0,,1977.0,,10122,10122,8170,7780,1952,2342,2929008
2016,38806,7919,7919,6578,6558,1341,1361,7752.0,,7033.0,,719.0,,7303,7303,5924,5649,1379,1654,2928950
2017,38814,17791,17791,14008,14114,3783,3677,17430.0,,14592.0,,2838.0,,17016,17016,12886,12787,4130,4229,2929107
2018,38822,12539,12539,10171,10215,2368,2324,12336.0,,10710.0,,1626.0,,10828,10828,8529,8464,2299,2364,2929057
2019,38830,32980,32980,26944,27062,6036,5918,32279.0,,28945.0,,3334.0,,31167,31167,26853,26784,4314,4383,2929206
2020,38857,29461,29461,24380,24625,5081,4836,28673.0,,24286.0,,4387.0,,27915,27915,23578,23284,4337,4631,2929305
2021,38865,8823,8823,6602,6744,2221,2079,8453.0,,7174.0,,1279.0,,7915,7915,5847,5869,2068,2046,2929370
2022,38873,9377,9377,7723,7712,1654,1665,9170.0,,7915.0,,1255.0,,8587,8587,6936,6839,1651,1748,2929404
2023,38890,35223,35223,27930,28198,7293,7025,34697.0,,28312.0,,6385.0,,33761,33761,27652,27200,6109,6561,2929503
2024,38911,15426,15426,12758,12865,2668,2561,14836.0,,12799.0,,2037.0,,13896,13896,11729,11862,2167,2034,2929602
2025,38938,14390,14390,10362,10435,4028,3955,14018.0,,10661.0,,3357.0,,13563,13563,9428,9073,4135,4490,2929701
2026,38946,12771,12771,9982,9871,2789,2900,12535.0,,10616.0,,1919.0,,11514,11514,8876,8421,2638,3093,2929750
2027,38954,9319,9319,6895,6903,2424,2416,9016.0,,7056.0,,1960.0,,8789,8789,6267,6203,2522,2586,2929800
2028,38970,33457,33457,28142,28599,5315,4858,31770.0,,27513.0,,4257.0,,30295,30295,25924,26206,4371,4089,2929909
2029,38997,7210,7210,5616,5713,1594,1497,7021.0,,5910.0,,1111.0,,7005,7005,5200,5174,1805,1831,2930006
2030,39012,52174,52174,41968,42592,10206,9582,49719.0,,40780.0,,8939.0,,48441,48441,39507,39319,8934,9122,2930105
2031,39039,30919,30919,22979,22699,7940,8220,30028.0,,24431.0,,5597.0,,28383,28383,20785,19560,7598,8823,2930204
2032,39047,26638,26638,19598,19648,7040,6990,25894.0,,20171.0,,5723.0,,23309,23309,16549,16179,6760,7130,2930154
2033,39055,15365,15365,11368,11510,3997,3855,15205.0,,12618.0,,2587.0,,15058,15058,10579,10466,4479,4592,2930303
2034,39071,17720,17720,13595,13378,4125,4342,17414.0,,14311.0,,3103.0,,16950,16950,12963,12204,3987,4746,2930402
2035,39098,61718,61718,51356,51474,10362,10244,58606.0,,50161.0,,8445.0,,55769,55769,47814,47735,7955,8034,2930501
2036,39110,10331,10331,8378,8306,1953,2025,9746.0,,8147.0,,1599.0,,9501,9501,7766,7879,1735,1622,2930600
2037,39136,87633,87633,70647,72137,16986,15496,82826.0,,67953.0,,14873.0,,78317,78317,64222,63479,14095,14838,2930709
2038,39144,10954,10954,8365,8337,2589,2617,10676.0,,9076.0,,1600.0,,9507,9507,6857,6505,2650,3002,2930758
2039,39152,14499,14499,11199,11316,3300,3183,14003.0,,11560.0,,2443.0,,13003,13003,10110,10020,2893,2983,2930808
2040,39179,11069,11069,8099,8179,2970,2890,10853.0,,9171.0,,1682.0,,10264,10264,7252,7262,3012,3002,2930907
2041,39195,17884,17884,14466,14789,3418,3095,17514.0,,15125.0,,2389.0,,16818,16818,13450,13452,3368,3366,2931004
2042,39217,7484,7484,6129,6108,1355,1376,7202.0,,5880.0,,1322.0,,7161,7161,5864,5671,1297,1490,2931103
2043,39233,14310,14310,11069,10976,3241,3334,14058.0,,11457.0,,2601.0,,12663,12663,9682,9618,2981,3045,2931202
2044,39250,12009,12009,8392,8321,3617,3688,11844.0,,9034.0,,2810.0,,11263,11263,7505,7392,3758,3871,2931301
2045,39276,6935,6935,5551,5453,1384,1482,6876.0,,5763.0,,1113.0,,6434,6434,4993,4742,1441,1692,2931400
2046,39292,18941,18941,13658,13684,5283,5257,18480.0,,14347.0,,4133.0,,17154,17154,12276,12261,4878,4893,2931509
2047,39314,11711,11711,9012,8995,2699,2716,11521.0,,9615.0,,1906.0,,10557,10557,8053,7902,2504,2655,2931608
2048,39330,10448,10448,8237,8164,2211,2284,10470.0,,8607.0,,1863.0,,9859,9859,7845,7415,2014,2444,2931707
2049,39357,16552,16552,11320,11532,5232,5020,16377.0,,12122.0,,4255.0,,16084,16084,10277,10037,5807,6047,2931806
2050,39373,39586,39586,31578,31573,8008,8013,37125.0,,30577.0,,6548.0,,36135,36135,28934,29291,7201,6844,2931905
2051,39390,22624,22624,17197,17226,5427,5398,21922.0,,17287.0,,4635.0,,21072,21072,15365,15225,5707,5847,2932002
2052,39411,16791,16791,12470,12638,4321,4153,16434.0,,13100.0,,3334.0,,16308,16308,11826,11894,4482,4414,2932101
2053,39438,14296,14296,10680,10610,3616,3686,14034.0,,11157.0,,2877.0,,13887,13887,10388,10349,3499,3538,2932200
2054,39454,12003,12003,9335,9345,2668,2658,11931.0,,9806.0,,2125.0,,11242,11242,9202,9284,2040,1958,2932309
2055,39470,12204,12204,9850,10055,2354,2149,12005.0,,9963.0,,2042.0,,11564,11564,8920,8963,2644,2601,2932408
2056,39489,10993,10993,8939,8764,2054,2229,10558.0,,9600.0,,958.0,,9744,9744,8231,7767,1513,1977,2932457
2057,39497,16033,16033,11896,11729,4137,4304,15734.0,,12118.0,,3616.0,,15168,15168,11367,10894,3801,4274,2932507
2058,39519,13465,13465,10253,10402,3212,3063,13100.0,,10696.0,,2404.0,,12710,12710,9303,9343,3407,3367,2932606
2059,39535,18752,18752,13856,13730,4896,5022,18433.0,,14343.0,,4090.0,,17270,17270,12419,12143,4851,5127,2932705
2060,39551,13381,13381,9829,9901,3552,3480,13243.0,,10345.0,,2898.0,,13075,13075,9312,9217,3763,3858,2932804
2061,39578,64598,64598,51570,52174,13028,12424,62138.0,,50002.0,,12136.0,,60690,60690,50721,50993,9969,9697,2932903
2062,39594,20058,20058,16491,16396,3567,3662,19482.0,,16217.0,,3265.0,,19284,19284,15707,15473,3577,3811,2933000
2063,39616,7072,7072,5411,5377,1661,1695,7035.0,,5827.0,,1208.0,,6551,6551,4801,4665,1750,1886,2933109
2064,39624,8725,8725,7224,7256,1501,1469,8322.0,,7296.0,,1026.0,,7902,7902,6493,6540,1409,1362,2933174
2065,39632,33065,33065,27039,27133,6026,5932,31310.0,,26275.0,,5035.0,,29267,29267,25289,24641,3978,4626,2933208
2066,39640,6803,6803,4994,5023,1809,1780,6825.0,,5771.0,,1054.0,,6230,6230,4377,4118,1853,2112,2933257
2067,39659,250908,250908,210642,213373,40266,37535,231176.0,231176.0,187550.0,189182.0,43626.0,41994.0,221849,221849,189803,191452,32046,30397,2933307
2068,39675,7361,7361,5341,5346,2020,2015,7244.0,,5600.0,,1644.0,,7206,7206,4960,4834,2246,2372,2933406
2069,39691,16899,16899,12687,12450,4212,4449,16552.0,,13613.0,,2939.0,,15576,15576,11864,11399,3712,4177,2933505
2070,39713,36866,36866,27092,27455,9774,9411,35998.0,,27740.0,,8258.0,,34740,34740,25098,25065,9642,9675,2933604
2071,39730,22750,22750,18398,18452,4352,4298,22055.0,,18506.0,,3549.0,,21311,21311,16377,16404,4934,4907,2919157
2072,39748,15679,15679,13253,13308,2426,2371,15310.0,,13734.0,,1576.0,,14496,14496,12728,12551,1768,1945,2919926
2073,39756,7289,7289,4798,4835,2491,2454,7175.0,,5440.0,,1735.0,,6790,6790,4240,4159,2550,2631,2919959
2074,39772,10628,10628,7185,6942,3443,3686,10352.0,,8840.0,,1512.0,,9694,9694,6219,5932,3475,3762,2920452
2075,39799,10823,10823,7836,7992,2987,2831,10777.0,,8379.0,,2398.0,,10379,10379,7009,7040,3370,3339,2922656
2076,39810,12102,12102,9556,9648,2546,2454,11899.0,,10365.0,,1534.0,,11247,11247,8752,8650,2495,2597,2924058
2077,39837,8570,8570,6525,6693,2045,1877,8328.0,,7170.0,,1158.0,,7919,7919,6323,6498,1596,1421,2924652
2078,39845,8944,8944,6784,6906,2160,2038,8785.0,,7437.0,,1348.0,,8098,8098,5969,5845,2129,2253,2925931
2079,39853,19501,19501,13848,14107,5653,5394,19114.0,,14982.0,,4132.0,,17634,17634,12387,12206,5247,5428,2925956
2080,39870,9949,9949,6429,6320,3520,3629,10202.0,,7455.0,,2747.0,,9109,9109,5602,5386,3507,3723,2928059
2081,39896,15747,15747,13236,13217,2511,2530,15050.0,,13239.0,,1811.0,,14537,14537,12428,12359,2109,2178,2929255
2082,39900,10220,10220,7680,7760,2540,2460,9996.0,,8001.0,,1995.0,,9629,9629,6825,6828,2804,2801,2930766
2083,39918,14549,14549,11562,11801,2987,2748,14091.0,,11950.0,,2141.0,,12911,12911,9852,10076,3059,2835,2931053
2084,39926,5092,5092,3794,3715,1298,1377,4937.0,,4119.0,,818.0,,4511,4511,3398,3364,1113,1147,2929354
2085,39934,112190,112190,81642,83069,30548,29121,108615.0,,80039.0,,28576.0,,104948,104948,75247,73191,29701,31757,2931350
2086,39942,8926,8926,7520,7543,1406,1383,8587.0,,7661.0,,926.0,,8107,8107,7102,6949,1005,1158,2923035
2087,39950,10799,10799,8079,8142,2720,2657,10505.0,,8555.0,,1950.0,,9244,9244,6787,6606,2457,2638,2933158
2088,39969,5513,5513,4095,4030,1418,1483,5609.0,,4542.0,,1067.0,,5296,5296,3743,3542,1553,1754,2922755
2089,39977,11522,11522,8427,8477,3095,3045,11235.0,,8954.0,,2281.0,,10827,10827,7873,7924,2954,2903,2933059
2090,39985,20026,20026,15598,15789,4428,4237,19474.0,,16228.0,,3246.0,,17594,17594,14168,13941,3426,3653,2930774
2091,39993,10946,10946,8501,8545,2445,2401,10861.0,,9444.0,,1417.0,,10198,10198,7805,7355,2393,2843,2933455
2092,40002,5785,5785,4907,4992,878,793,5616.0,,4930.0,,686.0,,5491,5491,4696,4666,795,825,3101631
2093,40010,5717,5717,4615,4696,1102,1021,5682.0,,4937.0,,745.0,,5769,5769,4613,4545,1156,1224,3100104
2094,40029,6418,6418,5078,5240,1340,1178,6382.0,,5497.0,,885.0,,5727,5727,4649,4699,1078,1028,3103751
2095,40037,18975,18975,14235,14484,4740,4491,18813.0,,14368.0,,4445.0,,18619,18619,13844,13647,4775,4972,3100203
2096,40045,11732,11732,8984,9068,2748,2664,11449.0,,9303.0,,2146.0,,11212,11212,8373,8199,2839,3013,3108552
2097,40053,11479,11479,9176,9321,2303,2158,10920.0,,9070.0,,1850.0,,10636,10636,8446,8286,2190,2350,3100302
2098,40061,4081,4081,2788,2837,1293,1244,4034.0,,3070.0,,964.0,,4135,4135,2966,2905,1169,1230,3112653
2099,40070,3538,3538,2662,2677,876,861,3617.0,,2941.0,,676.0,,3547,3547,2549,2521,998,1026,3100401
2100,40088,7679,7679,6114,6256,1565,1423,7746.0,,6640.0,,1106.0,,7700,7700,6063,5968,1637,1732,3114550
2101,40096,8595,8595,5590,5659,3005,2936,8539.0,,5991.0,,2548.0,,8765,8765,5603,5373,3162,3392,3100500
2102,40100,8072,8072,5747,5719,2325,2353,7870.0,,6222.0,,1648.0,,7642,7642,5518,5311,2124,2331,3115458
2103,40118,11888,11888,7785,7889,4103,3999,11942.0,,8645.0,,3297.0,,12109,12109,7781,7330,4328,4779,3100609
2104,40126,5271,5271,3900,3916,1371,1355,4980.0,,3978.0,,1002.0,,4874,4874,3445,3366,1429,1508,3122355
2105,40134,2386,2386,1822,1831,564,555,2464.0,,2115.0,,349.0,,2377,2377,1783,1745,594,632,3100708
2106,40142,6877,6877,5126,5235,1751,1642,6475.0,,5338.0,,1137.0,,6327,6327,4754,4689,1573,1638,3122454
2107,40150,4013,4013,3175,3244,838,769,4003.0,,3309.0,,694.0,,3976,3976,3061,2961,915,1015,3100807
2108,40169,6570,6570,5046,5131,1524,1439,6492.0,,5345.0,,1147.0,,6533,6533,4861,4800,1672,1733,3123528
2109,40177,15964,15964,11203,11538,4761,4426,15907.0,,11660.0,,4247.0,,15408,15408,10491,10337,4917,5071,3100906
2110,40185,5877,5877,4459,4617,1418,1260,5894.0,,4837.0,,1057.0,,5729,5729,4116,4030,1613,1699,3123858
2111,40193,10338,10338,6961,7048,3377,3290,10340.0,,7769.0,,2571.0,,10312,10312,6607,6528,3705,3784,3101003
2112,40207,8006,8006,6600,6825,1406,1181,7866.0,,6837.0,,1029.0,,8482,8482,6292,6240,2190,2242,3125952
2113,40215,19192,19192,14176,14425,5016,4767,19060.0,,14295.0,,4765.0,,19377,19377,14319,13924,5058,5453,3101102
2114,40223,5068,5068,3396,3450,1672,1618,5137.0,,3852.0,,1285.0,,5029,5029,3166,2957,1863,2072,3126752
2115,40231,5176,5176,3948,4063,1228,1113,5164.0,,3934.0,,1230.0,,5143,5143,3687,3668,1456,1475,3101201
2116,40240,8456,8456,6254,6328,2202,2128,8272.0,,6867.0,,1405.0,,7834,7834,5742,5550,2092,2284,3130051
2117,40258,2478,2478,1931,2002,547,476,2498.0,,2126.0,,372.0,,2499,2499,1924,1875,575,624,3101300
2118,40266,14060,14060,10071,10156,3989,3904,13929.0,,10799.0,,3130.0,,13960,13960,10302,10077,3658,3883,3131158
2119,40274,2981,2981,2354,2402,627,579,2827.0,,2447.0,,380.0,,2633,2633,2003,2018,630,615,3101409
2120,40282,25249,25249,19266,19540,5983,5709,24172.0,,19309.0,,4863.0,,23280,23280,17811,17318,5469,5962,3135050
2121,40290,28064,28064,21534,21660,6530,6404,28218.0,,20979.0,,7239.0,,28486,28486,21655,21078,6831,7408,3101508
2122,40304,4310,4310,3071,3078,1239,1232,4312.0,,3559.0,,753.0,,4195,4195,3185,2980,1010,1215,3135076
2123,40312,61363,61363,47153,48076,14210,13287,59705.0,,43050.0,,16655.0,,59594,59594,46129,45569,13465,14025,3101607
2124,40320,22894,22894,18280,18385,4614,4509,21661.0,,17072.0,,4589.0,,20981,20981,16627,16503,4354,4478,3136652
2125,40339,30543,30543,22124,22400,8419,8143,29995.0,,21672.0,,8323.0,,29763,29763,20944,20546,8819,9217,3101706
2126,40347,7471,7471,5770,5912,1701,1559,7399.0,,6058.0,,1341.0,,7122,7122,5433,5350,1689,1772,3137536
2127,40355,6492,6492,4587,4640,1905,1852,6549.0,,5078.0,,1471.0,,6354,6354,4707,4563,1647,1791,3101805
2128,40363,6095,6095,4981,5078,1114,1017,5858.0,,5136.0,,722.0,,5666,5666,4684,4606,982,1060,3138625
2129,40371,15797,15797,12413,12798,3384,2999,15432.0,,12252.0,,3180.0,,15481,15481,12276,12048,3205,3433,3101904
2130,40380,8289,8289,5933,6023,2356,2266,8088.0,,6451.0,,1637.0,,7930,7930,5488,5345,2442,2585,3138658
2131,40398,12093,12093,9670,9915,2423,2178,12022.0,,10151.0,,1871.0,,11861,11861,9534,9454,2327,2407,3102001
2132,40401,5658,5658,4693,4736,965,922,5456.0,,5100.0,,356.0,,5778,5778,4284,4194,1494,1584,3139250
2133,40410,10267,10267,7576,7584,2691,2683,10162.0,,7913.0,,2249.0,,10356,10356,7276,7058,3080,3298,3102100
2134,40428,6796,6796,5173,5161,1623,1635,6604.0,,5403.0,,1201.0,,6180,6180,4765,4689,1415,1491,3140555
2135,40436,4240,4240,3407,3465,833,775,4153.0,,3921.0,,232.0,,4428,4428,3294,3198,1134,1230,3102209
2136,40444,6984,6984,5127,5083,1857,1901,6757.0,,5327.0,,1430.0,,6615,6615,4804,4499,1811,2116,3140852
2137,40452,13109,13109,10329,10357,2780,2752,13021.0,,10532.0,,2489.0,,13224,13224,10220,9919,3004,3305,3102308
2138,40460,5969,5969,4273,4329,1696,1640,5973.0,,4908.0,,1065.0,,5632,5632,3973,3948,1659,1684,3143450
2139,40479,4386,4386,3110,3158,1276,1228,4356.0,,3625.0,,731.0,,4141,4141,2795,2659,1346,1482,3102407
2140,40487,5448,5448,4059,4107,1389,1341,5356.0,,4138.0,,1218.0,,5321,5321,3863,3816,1458,1505,3144359
2141,40495,4637,4637,3642,3630,995,1007,4727.0,,3907.0,,820.0,,4645,4645,3502,3397,1143,1248,3102506
2142,40509,9017,9017,5887,5994,3130,3023,8970.0,,6290.0,,2680.0,,8842,8842,5498,5498,3344,3344,3145356
2143,40517,30449,30449,23675,24118,6774,6331,29754.0,,22189.0,,7565.0,,29799,29799,23491,23442,6308,6357,3102605
2144,40525,6175,6175,4124,4252,2051,1923,6141.0,,4435.0,,1706.0,,6144,6144,3879,3863,2265,2281,3146750
2145,40533,7133,7133,5029,5126,2104,2007,7122.0,,5716.0,,1406.0,,6894,6894,4745,4696,2149,2198,3102704
2146,40541,7913,7913,5412,5432,2501,2481,7876.0,,5902.0,,1974.0,,7840,7840,5129,5011,2711,2829,3149150
2147,40550,9982,9982,7423,7620,2559,2362,9827.0,,7309.0,,2518.0,,9870,9870,7163,7081,2707,2789,3102803
2148,40568,6553,6553,4614,4753,1939,1800,6616.0,,5201.0,,1415.0,,6375,6375,4403,4290,1972,2085,3149952
2149,40576,9754,9754,7776,7882,1978,1872,9545.0,,7847.0,,1698.0,,9557,9557,7726,7569,1831,1988,3102902
2150,40584,9461,9461,6455,6474,3006,2987,9346.0,,7073.0,,2273.0,,8771,8771,6056,5903,2715,2868,3152170
2151,40592,8838,8838,6764,6793,2074,2045,8856.0,,7132.0,,1724.0,,8845,8845,6687,6357,2158,2488,3103009
2152,40606,5669,5669,4211,4294,1458,1375,5485.0,,4396.0,,1089.0,,5411,5411,3863,3704,1548,1707,3154457
2153,40614,1781,1781,1521,1510,260,271,1738.0,,1608.0,,130.0,,1969,1969,1581,1512,388,457,3103108
2154,40622,5072,5072,4116,4189,956,883,4951.0,,4266.0,,685.0,,4959,4959,3911,3917,1048,1042,3156452
2155,40630,2353,2353,1976,1953,377,400,2291.0,,2174.0,,117.0,,2754,2754,2025,1863,729,891,3103207
2156,40649,7306,7306,5681,5866,1625,1440,7307.0,,6055.0,,1252.0,,7044,7044,5299,5262,1745,1782,3157252
2157,40657,2486,2486,2030,1925,456,561,2473.0,,2254.0,,219.0,,2352,2352,1755,1604,597,748,3103306
2158,40665,5980,5980,4606,4788,1374,1192,6005.0,,5070.0,,935.0,,5904,5904,4538,4443,1366,1461,3159357
2159,40673,28118,28118,19065,19468,9053,8650,27725.0,,19281.0,,8444.0,,28221,28221,18297,18006,9924,10215,3103405
2160,40681,23806,23806,18029,18215,5777,5591,22377.0,,17133.0,,5244.0,,20863,20863,16030,15795,4833,5068,3158953
2161,40690,89352,89352,69217,70711,20135,18641,87563.0,,65900.0,,21663.0,,88211,88211,67932,67583,20279,20628,3103504
2162,40703,4891,4891,3741,3785,1150,1106,4865.0,,4123.0,,742.0,,4733,4733,3458,3325,1275,1408,3162252
2163,40711,2731,2731,2213,2255,518,476,2720.0,,2477.0,,243.0,,2561,2561,2056,2061,505,500,3103603
2164,40720,9134,9134,7297,7616,1837,1518,9139.0,,7998.0,,1141.0,,8541,8541,6750,6818,1791,1723,3162559
2165,40738,6796,6796,5347,5458,1449,1338,6731.0,,5550.0,,1181.0,,6676,6676,4891,4861,1785,1815,3103702
2166,40746,5187,5187,3777,3878,1410,1309,5246.0,,4416.0,,830.0,,5004,5004,3782,3704,1222,1300,3162575
2167,40754,3232,3232,2489,2596,743,636,3234.0,,2893.0,,341.0,,3162,3162,2429,2407,733,755,3103801
2168,40762,3927,3927,2917,2939,1010,988,3900.0,,3297.0,,603.0,,3832,3832,2696,2597,1136,1235,3162658
2169,40770,6457,6457,5346,5441,1111,1016,6350.0,,5364.0,,986.0,,6402,6402,5176,5111,1226,1291,3103900
2170,40789,19696,19696,16220,16313,3476,3383,19134.0,,15715.0,,3419.0,,18006,18006,14995,14729,3011,3277,3162955
2171,40797,80064,80064,63097,63883,16967,16181,77110.0,,58485.0,,18625.0,,76841,76841,60315,60132,16526,16709,3104007
2172,40800,25015,25015,20531,20942,4484,4073,23494.0,,19563.0,,3931.0,,20888,20888,17627,17520,3261,3368,3165537
2173,40819,7374,7374,5906,5985,1468,1389,7273.0,,6160.0,,1113.0,,7193,7193,5686,5628,1507,1565,3104106
2174,40827,3584,3584,2678,2495,906,1089,3597.0,,3020.0,,577.0,,3512,3512,2322,2089,1190,1423,3165560
2175,40835,32295,32295,26098,26458,6197,5837,31569.0,,24662.0,,6907.0,,31590,31590,25785,25445,5805,6145,3104205
2176,40843,5432,5432,4373,4532,1059,900,5358.0,,4764.0,,594.0,,5125,5125,4057,4091,1068,1034,3165578
2177,40851,11782,11782,9228,9401,2554,2381,11724.0,,9164.0,,2560.0,,11659,11659,9211,9051,2448,2608,3104304
2178,40860,10475,10475,7943,8064,2532,2411,10458.0,,8347.0,,2111.0,,10165,10165,7272,7094,2893,3071,3170057
2179,40878,2933,2933,2319,2320,614,613,2872.0,,2543.0,,329.0,,2818,2818,2193,2107,625,711,3104403
2180,40886,7717,7717,5413,5471,2304,2246,7456.0,,5913.0,,1543.0,,7332,7332,5197,4997,2135,2335,3170529
2181,40894,13886,13886,9695,10022,4191,3864,13672.0,,10235.0,,3437.0,,13563,13563,9109,8843,4454,4720,3104502
2182,40908,6102,6102,4332,4453,1770,1649,6158.0,,4822.0,,1336.0,,6444,6444,4338,4165,2106,2279,3170578
2183,40916,10826,10826,8729,8859,2097,1967,10808.0,,8822.0,,1986.0,,10841,10841,8537,8540,2304,2301,3104601
2184,40924,3439,3439,2248,2252,1191,1187,3394.0,,2661.0,,733.0,,3653,3653,2109,2043,1544,1610,3136579
2185,40932,11365,11365,7704,7754,3661,3611,11291.0,,8030.0,,3261.0,,11421,11421,7463,7022,3958,4399,3104700
2186,40940,5667,5667,3869,3874,1798,1793,5694.0,,4492.0,,1202.0,,5644,5644,3766,3665,1878,1979,3136959
2187,40959,4322,4322,2993,3039,1329,1283,4314.0,,3471.0,,843.0,,4349,4349,2928,2832,1421,1517,3104809
2188,40967,4280,4280,2958,3001,1322,1279,4222.0,,3472.0,,750.0,,4075,4075,2752,2714,1323,1361,3138351
2189,40975,15511,15511,12218,12639,3293,2872,15382.0,,11931.0,,3451.0,,15583,15583,12310,12271,3273,3312,3104908
2190,40983,5584,5584,4415,4696,1169,888,5569.0,,4761.0,,808.0,,5451,5451,4179,4251,1272,1200,3138674
2191,40991,7112,7112,5574,5609,1538,1503,7083.0,,5823.0,,1260.0,,6931,6931,5335,5119,1596,1812,3105004
2192,41009,6503,6503,4596,4622,1907,1881,6433.0,,5133.0,,1300.0,,6180,6180,4216,4098,1964,2082,3138682
2193,41017,19129,19129,14536,14734,4593,4395,18986.0,,14654.0,,4332.0,,19176,19176,14271,14164,4905,5012,3105103
2194,41025,12404,12404,9987,10158,2417,2246,12155.0,,10016.0,,2139.0,,11146,11146,9099,8948,2047,2198,3140159
2195,41033,4558,4558,3262,3317,1296,1241,4503.0,,3652.0,,851.0,,4327,4327,2959,2869,1368,1458,3105202
2196,41041,7781,7781,6086,6207,1695,1574,7497.0,,6306.0,,1191.0,,6934,6934,5252,5134,1682,1800,3140530
2197,41050,5266,5266,4154,4218,1112,1048,5228.0,,4234.0,,994.0,,5305,5305,4256,4259,1049,1046,3105301
2198,41068,4057,4057,2627,2673,1430,1384,3990.0,,2971.0,,1019.0,,3912,3912,2474,2405,1438,1507,3142254
2199,41076,24736,24736,19792,20064,4944,4672,24220.0,,19710.0,,4510.0,,23602,23602,18811,18711,4791,4891,3105400
2200,41084,4534,4534,2851,2902,1683,1632,4488.0,,3501.0,,987.0,,4464,4464,2844,2793,1620,1671,3143153
2201,41092,5511,5511,4311,4322,1200,1189,5545.0,,4799.0,,746.0,,5527,5527,4363,4171,1164,1356,3105509
2202,41106,3091,3091,2398,2428,693,663,3093.0,,2709.0,,384.0,,2958,2958,2213,2111,745,847,3144375
2203,41114,99574,99574,80424,81446,19150,18128,98188.0,,75256.0,,22932.0,,98685,98685,79971,79121,18714,19564,3105608
2204,41122,8356,8356,5624,5781,2732,2575,8274.0,,6231.0,,2043.0,,7822,7822,4892,4927,2930,2895,3144656
2205,41130,5782,5782,4405,4412,1377,1370,5669.0,,4511.0,,1158.0,,5620,5620,4004,3917,1616,1703,3105707
2206,41149,3634,3634,2593,2676,1041,958,3688.0,,3084.0,,604.0,,3408,3408,2636,2482,772,926,3144672
2207,41157,24311,24311,18239,18423,6072,5888,23784.0,,18687.0,,5097.0,,23372,23372,17468,16918,5904,6454,3169356
2208,41165,5709,5709,4721,4834,988,875,5567.0,,4838.0,,729.0,,5359,5359,4470,4443,889,916,3145059
2209,41173,17395,17395,14045,14213,3350,3182,17198.0,,13898.0,,3300.0,,17314,17314,13731,13495,3583,3819,3105905
2210,41181,4776,4776,3485,3553,1291,1223,4707.0,,3903.0,,804.0,,4471,4471,3148,3116,1323,1355,3145372
2211,41190,7956,7956,6538,6544,1418,1412,7820.0,,6422.0,,1398.0,,7791,7791,6430,6262,1361,1529,3106002
2212,41203,5316,5316,3930,3970,1386,1346,5252.0,,4409.0,,843.0,,5062,5062,3593,3472,1469,1590,3145455
2213,41211,3007,3007,2446,2468,561,539,2991.0,,2581.0,,410.0,,2998,2998,2402,2335,596,663,3106101
2214,41220,4447,4447,3486,3477,961,970,4434.0,,3575.0,,859.0,,4324,4324,3289,3170,1035,1154,3145851
2215,41238,2006854,2006854,1569591,1609327,437263,397527,1943184.0,,1392551.0,,550633.0,,1956410,1956410,1555751,1552603,400659,403807,3106200
2216,41246,6446,6446,4991,5125,1455,1321,6427.0,,5358.0,,1069.0,,6459,6459,4793,4753,1666,1706,3145877
2217,41254,19831,19831,14898,15049,4933,4782,19792.0,,15757.0,,4035.0,,19173,19173,14178,13964,4995,5209,3106309
2218,41262,4987,4987,3191,3229,1796,1758,4985.0,,3853.0,,1132.0,,4854,4854,3019,2891,1835,1963,3146255
2219,41270,8019,8019,6548,6681,1471,1338,7851.0,,6744.0,,1107.0,,7689,7689,6248,6210,1441,1479,3106408
2220,41289,5348,5348,3951,3982,1397,1366,5295.0,,4432.0,,863.0,,5030,5030,3676,3541,1354,1489,3146552
2221,41297,9077,9077,5859,5898,3218,3179,9002.0,,6305.0,,2697.0,,9420,9420,5707,5521,3713,3899,3106507
2222,41300,5269,5269,3837,3827,1432,1442,5226.0,,4513.0,,713.0,,4983,4983,3512,3322,1471,1661,3147956
2223,41319,4293,4293,3106,3156,1187,1137,4163.0,,3408.0,,755.0,,4089,4089,2839,2780,1250,1309,3106606
2224,41327,5762,5762,4808,4938,954,824,5471.0,,5046.0,,425.0,,5243,5243,4384,4315,859,928,3148756
2225,41335,290957,290957,247373,248739,43584,42218,274502.0,,229695.0,,44807.0,,259410,259410,232399,230990,27011,28420,3106705
2226,41343,7992,7992,5874,6102,2118,1890,7703.0,,6393.0,,1310.0,,7324,7324,5478,5442,1846,1882,3150158
2227,41351,3759,3759,2954,2901,805,858,3770.0,,3428.0,,342.0,,3618,3618,2831,2584,787,1034,3106804
2228,41360,4142,4142,3188,3278,954,864,3985.0,,3515.0,,470.0,,4155,4155,2981,2824,1174,1331,3150539
2229,41378,11663,11663,8987,9122,2676,2541,11531.0,,8779.0,,2752.0,,11595,11595,8718,8636,2877,2959,3106903
2230,41386,6517,6517,4271,4441,2246,2076,6440.0,,4891.0,,1549.0,,6291,6291,4046,4025,2245,2266,3150570
2231,41394,2470,2470,1980,2061,490,409,2435.0,,2254.0,,181.0,,2970,2970,2076,2007,894,963,3107000
2232,41408,3868,3868,2642,2666,1226,1202,3929.0,,3206.0,,723.0,,3784,3784,2597,2456,1187,1328,3152131
2233,41416,32303,32303,24423,25076,7880,7227,31718.0,,23259.0,,8459.0,,31761,31761,23770,23538,7991,8223,3107109
2234,41424,5862,5862,4499,4655,1363,1207,5750.0,,4593.0,,1157.0,,5711,5711,4238,4226,1473,1485,3154150
2235,41432,4467,4467,3521,3604,946,863,4387.0,,3733.0,,654.0,,4487,4487,3413,3388,1074,1099,3107208
2236,41440,3292,3292,2621,2726,671,566,3206.0,,2875.0,,331.0,,3059,3059,2482,2415,577,644,3157278
2237,41459,37215,37215,28155,29112,9060,8103,36563.0,,28717.0,,7846.0,,36023,36023,26499,26300,9524,9723,3107307
2238,41467,6533,6533,5321,5454,1212,1079,6393.0,,5227.0,,1166.0,,6566,6566,5337,5300,1229,1266,3157336
2239,41475,38923,38923,30118,30839,8805,8084,38258.0,,28435.0,,9823.0,,38235,38235,29968,29570,8267,8665,3107406
2240,41483,4347,4347,2999,3068,1348,1279,4285.0,,3356.0,,929.0,,4364,4364,2851,2834,1513,1530,3157377
2241,41491,5908,5908,4651,4789,1257,1119,5770.0,,4863.0,,907.0,,5816,5816,4505,4508,1311,1308,3107505
2242,41505,5462,5462,3878,4018,1584,1444,5423.0,,4692.0,,731.0,,5007,5007,3481,3396,1526,1611,3157658
2243,41513,3531,3531,2830,2875,701,656,3401.0,,2844.0,,557.0,,3421,3421,2745,2691,676,730,3107604
2244,41521,6284,6284,4550,4569,1734,1715,5971.0,,4775.0,,1196.0,,5984,5984,4126,4062,1858,1922,3160454
2245,41530,5100,5100,4028,4149,1072,951,4893.0,,3939.0,,954.0,,4859,4859,3927,3828,932,1031,3107703
2246,41548,5391,5391,4177,4280,1214,1111,5206.0,,4470.0,,736.0,,4941,4941,3950,3958,991,983,3160959
2247,41556,12440,12440,9492,9790,2948,2650,12355.0,,10223.0,,2132.0,,12112,12112,9284,8860,2828,3252,3107802
2248,41564,3206,3206,2453,2479,753,727,3670.0,,3114.0,,556.0,,3546,3546,2475,2413,1071,1133,3161056
2249,41572,8920,8920,7524,7682,1396,1238,8612.0,,7539.0,,1073.0,,8612,8612,7049,7147,1563,1465,3107901
2250,41580,3179,3179,2286,2325,893,854,3152.0,,2608.0,,544.0,,3149,3149,2260,2190,889,959,3161650
2251,41599,15529,15529,11642,11766,3887,3763,15386.0,,11625.0,,3761.0,,15417,15417,11755,11503,3662,3914,3108008
2252,41602,9481,9481,7106,7205,2375,2276,9185.0,,7496.0,,1689.0,,8887,8887,6691,6543,2196,2344,3162450
2253,41610,7069,7069,5571,5660,1498,1409,6849.0,,5611.0,,1238.0,,6851,6851,5335,5322,1516,1529,3108107
2254,41629,21374,21374,16797,17049,4577,4325,20105.0,,15842.0,,4263.0,,19236,19236,15086,14962,4150,4274,3162922
2255,41637,5046,5046,3612,3727,1434,1319,5001.0,,3939.0,,1062.0,,5114,5114,3443,3338,1671,1776,3108206
2256,41645,6563,6563,5124,5221,1439,1342,6442.0,,5260.0,,1182.0,,6220,6220,4787,4625,1433,1595,3162948
2257,41653,13306,13306,10391,10651,2915,2655,13228.0,,10222.0,,3006.0,,13371,13371,10466,10458,2905,2913,3108305
2258,41661,4311,4311,3640,3724,671,587,4177.0,,3667.0,,510.0,,4164,4164,3454,3428,710,736,3102050
2259,41670,12905,12905,9764,9982,3141,2923,12774.0,,9549.0,,3225.0,,12757,12757,9686,9684,3071,3073,3108404
2260,41688,6728,6728,4697,4771,2031,1957,6745.0,,5139.0,,1606.0,,6593,6593,4335,4103,2258,2490,3102852
2261,41696,5427,5427,3840,3871,1587,1556,5298.0,,4254.0,,1044.0,,5250,5250,3594,3395,1656,1855,3108503
2262,41700,4863,4863,3466,3446,1397,1417,4842.0,,3752.0,,1090.0,,4659,4659,3228,3153,1431,1506,3104452
2263,41718,27220,27220,19553,19933,7667,7287,26682.0,,19805.0,,6877.0,,26720,26720,18777,18306,7943,8414,3108602
2264,41726,4005,4005,3147,3202,858,803,3987.0,,3418.0,,569.0,,3780,3780,2908,2751,872,1029,3106655
2265,41734,4596,4596,3259,3417,1337,1179,4596.0,,3937.0,,659.0,,4494,4494,3038,3038,1456,1456,3108701
2266,41742,8240,8240,5701,5687,2539,2553,8054.0,,6329.0,,1725.0,,7673,7673,5289,4968,2384,2705,3108255
2267,41750,4417,4417,3082,3168,1335,1249,4452.0,,3558.0,,894.0,,4313,4313,3121,3026,1192,1287,3108800
2268,41769,4422,4422,3224,3255,1198,1167,4288.0,,3559.0,,729.0,,4222,4222,3122,2980,1100,1242,3109253
2269,41777,12766,12766,9590,9904,3176,2862,12676.0,,9384.0,,3292.0,,13061,13061,9708,9686,3353,3375,3108909
2270,41785,5507,5507,4117,4128,1390,1379,5430.0,,4423.0,,1007.0,,5348,5348,3962,3821,1386,1527,3109451
2271,41793,32326,32326,26026,26309,6300,6017,30689.0,,24952.0,,5737.0,,28170,28170,22607,22610,5563,5560,3109006
2272,41807,4139,4139,2862,2835,1277,1304,4163.0,,3559.0,,604.0,,3960,3960,2649,2470,1311,1490,3111150
2273,41815,8908,8908,6789,7048,2119,1860,8775.0,,6697.0,,2078.0,,8943,8943,6844,6892,2099,2051,3109105
2274,41823,3763,3763,2619,2679,1144,1084,3770.0,,3089.0,,681.0,,3862,3862,2592,2526,1270,1336,3112059
2275,41831,8483,8483,5369,5443,3114,3040,8495.0,,5965.0,,2530.0,,8540,8540,5232,5089,3308,3451,3109204
2276,41840,4831,4831,3914,3927,917,904,4707.0,,3931.0,,776.0,,4629,4629,3719,3651,910,978,3115359
2277,41858,19057,19057,14185,14555,4872,4502,18723.0,,14586.0,,4137.0,,18521,18521,13431,12907,5090,5614,3109303
2278,41866,4411,4411,3330,3386,1081,1025,4291.0,,3659.0,,632.0,,4303,4303,3110,3067,1193,1236,3115474
2279,41874,19516,19516,14350,14560,5166,4956,19208.0,,14762.0,,4446.0,,19107,19107,13681,13302,5426,5805,3109402
2280,41882,8859,8859,6517,6604,2342,2255,8566.0,,6803.0,,1763.0,,8194,8194,5853,5791,2341,2403,3116159
2281,41890,9590,9590,7607,7748,1983,1842,9622.0,,7727.0,,1895.0,,9717,9717,7561,7460,2156,2257,3109501
2282,41904,6179,6179,4465,4520,1714,1659,6079.0,,4787.0,,1292.0,,5915,5915,4235,4134,1680,1781,3117836
2283,41912,3537,3537,2876,2906,661,631,3600.0,,3029.0,,571.0,,3514,3514,2762,2754,752,760,3109600
2284,41920,6592,6592,5565,5546,1027,1046,6442.0,,5582.0,,860.0,,6142,6142,5136,5062,1006,1080,3117876
2285,41939,9710,9710,7851,8019,1859,1691,9484.0,,7534.0,,1950.0,,9427,9427,7618,7561,1809,1866,3109709
2286,41947,5254,5254,4296,4411,958,843,5165.0,,4519.0,,646.0,,5171,5171,4235,4212,936,959,3119955
2287,41955,2415,2415,1886,1895,529,520,2323.0,,2149.0,,174.0,,2202,2202,1650,1589,552,613,3109808
2288,41963,4809,4809,3391,3423,1418,1386,4819.0,,3827.0,,992.0,,4887,4887,3260,3226,1627,1661,3120151
2289,41971,8720,8720,7029,7052,1691,1668,8606.0,,6924.0,,1682.0,,8371,8371,6596,6526,1775,1845,3109907
2290,41980,4257,4257,2858,2858,1399,1399,4253.0,,3431.0,,822.0,,4205,4205,3073,2843,1132,1362,3120839
2291,41998,34242,34242,26972,27195,7270,7047,33493.0,,26061.0,,7432.0,,33679,33679,26805,26300,6874,7379,3110004
2292,42005,6375,6375,4657,4800,1718,1575,6095.0,,4957.0,,1138.0,,6072,6072,4259,4169,1813,1903,3120870
2293,42013,4142,4142,3322,3376,820,766,4106.0,,3516.0,,590.0,,3914,3914,3044,2969,870,945,3110103
2294,42021,6872,6872,5345,5352,1527,1520,6604.0,,5203.0,,1401.0,,6092,6092,4607,4537,1485,1555,3121258
2295,42030,4581,4581,3767,3786,814,795,4475.0,,3964.0,,511.0,,4216,4216,3470,3416,746,800,3110202
2296,42048,3570,3570,2720,2748,850,822,3574.0,,3081.0,,493.0,,3401,3401,2437,2357,964,1044,3122470
2297,42056,10973,10973,8519,8670,2454,2303,10947.0,,8353.0,,2594.0,,11047,11047,8665,8639,2382,2408,3110301
2298,42064,3527,3527,2642,2667,885,860,3526.0,,3167.0,,359.0,,3233,3233,2511,2430,722,803,3126950
2299,42072,2994,2994,2553,2611,441,383,2932.0,,2758.0,,174.0,,3418,3418,2573,2532,845,886,3110400
2300,42080,5074,5074,3196,3228,1878,1846,5056.0,,3617.0,,1439.0,,5047,5047,3007,2876,2040,2171,3127073
2301,42099,18312,18312,13860,14197,4452,4115,17643.0,,13142.0,,4501.0,,17215,17215,13059,13019,4156,4196,3110509
2302,42102,4526,4526,3514,3504,1012,1022,4435.0,,3791.0,,644.0,,4333,4333,3240,3136,1093,1197,3127339
2303,42110,21966,21966,16783,17175,5183,4791,21372.0,,15602.0,,5770.0,,21379,21379,16411,16327,4968,5052,3110608
2304,42129,3772,3772,3118,3098,654,674,3695.0,,3282.0,,413.0,,3662,3662,2852,2680,810,982,3127354
2305,42137,10268,10268,7819,7903,2449,2365,10301.0,,7958.0,,2343.0,,10319,10319,7851,7743,2468,2576,3110707
2306,42145,2899,2899,2284,2325,615,574,2717.0,,2491.0,,226.0,,3031,3031,2215,2134,816,897,3127370
2307,42153,3389,3389,2280,2285,1109,1104,3450.0,,2746.0,,704.0,,3394,3394,2329,2202,1065,1192,3110806
2308,42161,4133,4133,3234,3282,899,851,4131.0,,3419.0,,712.0,,3871,3871,2911,2867,960,1004,3127388
2309,42170,12537,12537,9647,9825,2890,2712,12345.0,,9431.0,,2914.0,,12188,12188,9315,9113,2873,3075,3110905
2310,42188,4909,4909,3972,4101,937,808,4888.0,,4351.0,,537.0,,4674,4674,3766,3720,908,954,3128253
2311,42196,16841,16841,13214,13542,3627,3299,16829.0,,13440.0,,3389.0,,16623,16623,13253,13226,3370,3397,3111002
2312,42200,5950,5950,4008,3909,1942,2041,5880.0,,4408.0,,1472.0,,5968,5968,3930,3769,2038,2199,3129657
2313,42218,14762,14762,11007,11510,3755,3252,14803.0,,11229.0,,3574.0,,15209,15209,11110,11075,4099,4134,3111101
2314,42226,5346,5346,4258,4368,1088,978,5238.0,,4796.0,,442.0,,5984,5984,4251,4165,1733,1819,3130556
2315,42234,39977,39977,30342,31211,9635,8766,40021.0,,28862.0,,11159.0,,40114,40114,30362,30051,9752,10063,3111200
2316,42242,6283,6283,4248,4474,2035,1809,6290.0,,4871.0,,1419.0,,6235,6235,4003,3980,2232,2255,3130655
2317,42250,10111,10111,7777,7856,2334,2255,10016.0,,8320.0,,1696.0,,10112,10112,7690,7476,2422,2636,3111309
2318,42269,8361,8361,6096,6064,2265,2297,8161.0,,6433.0,,1728.0,,8025,8025,5417,5256,2608,2769,3135357
2319,42277,6374,6374,4973,5034,1401,1340,6303.0,,5415.0,,888.0,,5769,5769,4525,4388,1244,1381,3111408
2320,42285,5958,5958,3717,3789,2241,2169,5844.0,,4060.0,,1784.0,,5698,5698,3326,3219,2372,2479,3135456
2321,42293,10479,10479,7364,7512,3115,2967,10401.0,,7587.0,,2814.0,,10448,10448,7371,7279,3077,3169,3111507
2322,42307,3802,3802,2631,2560,1171,1242,3784.0,,2962.0,,822.0,,3903,3903,2639,2483,1264,1420,3136520
2323,42315,20751,20751,15683,15948,5068,4803,20556.0,,15852.0,,4704.0,,20723,20723,15369,15301,5354,5422,3111606
2324,42323,4250,4250,2801,2861,1449,1389,4297.0,,3288.0,,1009.0,,4308,4308,2711,2631,1597,1677,3136553
2325,42331,4326,4326,3588,3656,738,670,4296.0,,3792.0,,504.0,,4199,4199,3401,3394,798,805,3111705
2326,42340,2756,2756,2342,2377,414,379,2657.0,,2501.0,,156.0,,2509,2509,2119,2135,390,374,3164431
2327,42358,8821,8821,6658,6861,2163,1960,8882.0,,6984.0,,1898.0,,8927,8927,6408,6360,2519,2567,3111804
2328,42366,5567,5567,3849,3970,1718,1597,5599.0,,4475.0,,1124.0,,5402,5402,3795,3781,1607,1621,3164472
2329,42374,4772,4772,3884,3950,888,822,4755.0,,4083.0,,672.0,,4711,4711,3861,3800,850,911,3111903
2330,42382,3967,3967,3042,3092,925,875,3910.0,,3247.0,,663.0,,3900,3900,2879,2862,1021,1038,3166956
2331,42390,12161,12161,9317,9612,2844,2549,12102.0,,9211.0,,2891.0,,12148,12148,9160,9181,2988,2967,3112000
2332,42404,9009,9009,5801,5934,3208,3075,9019.0,,6462.0,,2557.0,,8510,8510,5291,5176,3219,3334,3165552
2333,42412,4316,4316,3424,3507,892,809,4232.0,,3524.0,,708.0,,4318,4318,3365,3247,953,1071,3112109
2334,42420,3657,3657,2823,2878,834,779,3543.0,,3188.0,,355.0,,3257,3257,2477,2439,780,818,3168051
2335,42439,4463,4463,3710,3735,753,728,4414.0,,3925.0,,489.0,,4347,4347,3528,3484,819,863,3112208
2336,42447,2989,2989,2454,2485,535,504,2958.0,,2722.0,,236.0,,2904,2904,2348,2263,556,641,3170438
2337,42455,29480,29480,21711,22276,7769,7204,28148.0,,20990.0,,7158.0,,27826,27826,19721,19467,8105,8359,3112307
2338,42463,3480,3480,2557,2585,923,895,3451.0,,2988.0,,463.0,,3213,3213,2352,2283,861,930,3170479
2339,42471,5717,5717,4186,4250,1531,1467,5734.0,,4402.0,,1332.0,,5841,5841,4122,4095,1719,1746,3112406
2340,42480,4206,4206,3155,3191,1051,1015,4174.0,,3527.0,,647.0,,4036,4036,2944,2956,1092,1080,3170651
2341,42498,8150,8150,6629,6694,1521,1456,7946.0,,6611.0,,1335.0,,7912,7912,6526,6436,1386,1476,3112505
2342,42501,6559,6559,5092,5175,1467,1384,5887.0,,5063.0,,824.0,,5629,5629,4340,4224,1289,1405,3170750
2343,42510,11538,11538,8929,9220,2609,2318,11336.0,,8800.0,,2536.0,,11311,11311,8741,8612,2570,2699,3112604
2344,42528,6924,6924,4880,4880,2044,2044,6979.0,,5467.0,,1512.0,,6754,6754,4623,4494,2131,2260,3171030
2345,42536,12472,12472,9422,9556,3050,2916,12312.0,,9924.0,,2388.0,,12395,12395,9182,8909,3213,3486,3112703
2346,42544,5092,5092,3765,3849,1327,1243,5012.0,,4199.0,,813.0,,4946,4946,3599,3517,1347,1429,3171071
2347,42552,7862,7862,6032,6239,1830,1623,7556.0,,5985.0,,1571.0,,7465,7465,5612,5543,1853,1922,3112802
2348,42560,4779,4779,3800,3854,979,925,4696.0,,3949.0,,747.0,,4718,4718,3694,3584,1024,1134,3171154
2349,42579,8083,8083,6407,6658,1676,1425,8003.0,,6908.0,,1095.0,,7812,7812,6118,6033,1694,1779,3112901
2350,42587,3970,3970,3339,3407,631,563,3880.0,,3402.0,,478.0,,3872,3872,3194,3214,678,658,3169059
2351,42595,14999,14999,9836,9845,5163,5154,14675.0,,10099.0,,4576.0,,14831,14831,9365,9209,5466,5622,3113008
2352,42617,3208,3208,2649,2650,559,558,3174.0,,2825.0,,349.0,,3132,3132,2544,2497,588,635,3113107
2353,42633,20419,20419,17180,17385,3239,3034,20050.0,,17164.0,,2886.0,,19984,19984,16703,16539,3281,3445,3113206
2354,42650,25353,25353,18967,19225,6386,6128,25588.0,,18915.0,,6673.0,,25175,25175,18146,17884,7029,7291,3113305
2355,42676,65233,65233,48450,49704,16783,15529,65142.0,,48195.0,,16947.0,,61849,61849,45286,44427,16563,17422,3113404
2356,42692,8012,8012,5803,5897,2209,2115,7926.0,,6131.0,,1795.0,,7924,7924,5481,5358,2443,2566,3113503
2357,42714,5083,5083,4014,4043,1069,1040,5004.0,,4165.0,,839.0,,4963,4963,3868,3774,1095,1189,3113602
2358,42730,16606,16606,11261,11304,5345,5302,16491.0,,11617.0,,4874.0,,16585,16585,10891,10367,5694,6218,3113701
2359,42757,2408,2408,1805,1846,603,562,2265.0,,1941.0,,324.0,,2218,2218,1563,1526,655,692,3113800
2360,42773,9608,9608,7281,7400,2327,2208,9558.0,,7435.0,,2123.0,,9628,9628,7313,7141,2315,2487,3113909
2361,42790,9946,9946,7890,7957,2056,1989,9923.0,,8078.0,,1845.0,,10056,10056,7958,7778,2098,2278,3114006
2362,42811,10019,10019,7876,8017,2143,2002,9949.0,,7795.0,,2154.0,,9988,9988,7819,7758,2169,2230,3114105
2363,42838,18681,18681,15417,15576,3264,3105,18088.0,,14396.0,,3692.0,,17938,17938,14870,14800,3068,3138,3114204
2364,42854,22807,22807,16799,17718,6008,5089,22351.0,,17258.0,,5093.0,,22464,22464,16351,16439,6113,6025,3114303
2365,42870,15770,15770,12344,12552,3426,3218,15547.0,,12032.0,,3515.0,,15667,15667,12134,11975,3533,3692,3114402
2366,42897,14147,14147,11591,11898,2556,2249,14053.0,,11667.0,,2386.0,,13235,13235,10808,10805,2427,2430,3114501
2367,42919,3495,3495,2759,2819,736,676,3424.0,,2848.0,,576.0,,3296,3296,2623,2540,673,756,3114600
2368,42935,3267,3267,2668,2719,599,548,3208.0,,2817.0,,391.0,,3088,3088,2539,2576,549,512,3114709
2369,42951,4040,4040,3262,3338,778,702,3972.0,,3476.0,,496.0,,3982,3982,3087,3012,895,970,3114808
2370,42978,2547,2547,2220,2230,327,317,2707.0,,2537.0,,170.0,,2518,2518,2028,2012,490,506,3114907
2371,42994,3522,3522,2673,2700,849,822,3424.0,,3071.0,,353.0,,3164,3164,2482,2340,682,824,3115003
2372,43010,14341,14341,10471,10855,3870,3486,14118.0,,10335.0,,3783.0,,14276,14276,10282,10278,3994,3998,3115102
2373,43036,3690,3690,3075,3061,615,629,3665.0,,3309.0,,356.0,,3592,3592,2962,2839,630,753,3115201
2374,43052,53820,53820,41534,41869,12286,11951,53424.0,,39807.0,,13617.0,,54268,54268,41604,40918,12664,13350,3115300
2375,43079,3860,3860,3027,3021,833,839,3801.0,,3415.0,,386.0,,3776,3776,2965,2653,811,1123,3115409
2376,43095,18108,18108,13141,13442,4967,4666,17871.0,,12650.0,,5221.0,,18200,18200,13220,13062,4980,5138,3115508
2377,43117,1291,1291,951,943,340,348,1288.0,,1147.0,,141.0,,1275,1275,908,876,367,399,3115607
2378,43133,5993,5993,4216,4336,1777,1657,6033.0,,4884.0,,1149.0,,5919,5919,4309,4217,1610,1702,3115706
2379,43150,7360,7360,5833,5996,1527,1364,7235.0,,6250.0,,985.0,,7030,7030,5502,5444,1528,1586,3115805
2380,43176,3623,3623,3080,3034,543,589,3428.0,,3141.0,,287.0,,2649,2649,2260,2242,389,407,3115904
2381,43192,5237,5237,4209,4356,1028,881,5299.0,,4659.0,,640.0,,4959,4959,3844,3763,1115,1196,3116001
2382,43214,9393,9393,5799,5903,3594,3490,9386.0,,6611.0,,2775.0,,9796,9796,5641,5390,4155,4406,3116100
2383,43230,2933,2933,2413,2399,520,534,2965.0,,2670.0,,295.0,,2689,2689,2273,2203,416,486,3116209
2384,43257,5789,5789,3937,4098,1852,1691,5790.0,,4596.0,,1194.0,,5764,5764,3647,3654,2117,2110,3116308
2385,43273,4578,4578,3665,3799,913,779,4579.0,,3801.0,,778.0,,4626,4626,3639,3650,987,976,3116407
2386,43290,7485,7485,5895,5952,1590,1533,7460.0,,6466.0,,994.0,,6961,6961,5521,5294,1440,1667,3116506
2387,43311,21791,21791,17912,18227,3879,3564,20960.0,,17136.0,,3824.0,,20612,20612,16855,16828,3757,3784,3116605
2388,43338,6343,6343,5304,5428,1039,915,6187.0,,5379.0,,808.0,,6098,6098,5145,5177,953,921,3116704
2389,43354,6839,6839,4789,4845,2050,1994,6814.0,,4985.0,,1829.0,,6958,6958,4689,4567,2269,2391,3116803
2390,43370,2830,2830,2106,2218,724,612,2842.0,,2467.0,,375.0,,2569,2569,1928,1903,641,666,3116902
2391,43397,6796,6796,4702,4747,2094,2049,6799.0,,4935.0,,1864.0,,6862,6862,4453,4403,2409,2459,3117009
2392,43419,8077,8077,6441,6466,1636,1611,7845.0,,6284.0,,1561.0,,7951,7951,6253,6230,1698,1721,3117108
2393,43435,2699,2699,2180,2235,519,464,2729.0,,2463.0,,266.0,,2638,2638,2091,2078,547,560,3117207
2394,43451,19641,19641,15155,15552,4486,4089,19146.0,,15194.0,,3952.0,,19467,19467,14502,14531,4965,4936,3117306
2395,43478,4205,4205,3298,3365,907,840,4205.0,,3649.0,,556.0,,3860,3860,2966,2955,894,905,3117405
2396,43494,18123,18123,13309,13481,4814,4642,17088.0,,12803.0,,4285.0,,16343,16343,11384,11193,4959,5150,3117504
2397,43516,5117,5117,4027,4137,1090,980,5082.0,,4234.0,,848.0,,5066,5066,3952,3884,1114,1182,3117603
2398,43532,10387,10387,7987,8072,2400,2315,10298.0,,8090.0,,2208.0,,10452,10452,7960,7793,2492,2659,3117702
2399,43559,8628,8628,7345,7449,1283,1179,8366.0,,7385.0,,981.0,,8173,8173,7031,7039,1142,1134,3117801
2400,43575,9337,9337,7653,7831,1684,1506,8928.0,,7864.0,,1064.0,,8622,8622,7130,7140,1492,1482,3117900
2401,43591,42200,42200,35171,35416,7029,6784,41190.0,,34529.0,,6661.0,,40791,40791,34477,34022,6314,6769,3118007
2402,43613,4227,4227,2960,3021,1267,1206,4171.0,,3204.0,,967.0,,4151,4151,2821,2754,1330,1397,3118106
2403,43630,5422,5422,4400,4481,1022,941,5455.0,,4651.0,,804.0,,5309,5309,4239,4253,1070,1056,3118205
2404,43656,97282,97282,81251,81927,16031,15355,96053.0,,76400.0,,19653.0,,93099,93099,77771,76957,15328,16142,3118304
2405,43672,16876,16876,11815,11960,5061,4916,16850.0,,12544.0,,4306.0,,17130,17130,12322,11909,4808,5221,3118403
2406,43699,1923,1923,1421,1452,502,471,1929.0,,1554.0,,375.0,,1865,1865,1385,1333,480,532,3118502
2407,43710,452185,452185,379128,383863,73057,68322,427575.0,427575.0,342088.0,329488.0,85487.0,98087.0,400069,400069,355970,354366,44099,45703,3118601
2408,43737,7747,7747,5999,6102,1748,1645,7733.0,,6031.0,,1702.0,,7780,7780,5936,5844,1844,1936,3118700
2409,43753,21237,21237,15613,15775,5624,5462,20927.0,,16301.0,,4626.0,,21332,21332,15038,14390,6294,6942,3118809
2410,43770,7189,7189,5619,5646,1570,1543,7220.0,,5818.0,,1402.0,,7178,7178,5423,5216,1755,1962,3118908
2411,43796,2728,2728,2147,2184,581,544,2742.0,,2394.0,,348.0,,2688,2688,2171,2106,517,582,3119005
2412,43818,20059,20059,14092,14260,5967,5799,19686.0,,14391.0,,5295.0,,19995,19995,13767,13380,6228,6615,3119104
2413,43834,7634,7634,5806,5865,1828,1769,8947.0,,7032.0,,1915.0,,9329,9329,6439,5954,2890,3375,3119203
2414,43850,24122,24122,18478,18842,5644,5280,23694.0,,18892.0,,4802.0,,23596,23596,18047,17773,5549,5823,3119302
2415,43877,81861,81861,62192,62997,19669,18864,80313.0,,59020.0,,21293.0,,81021,81021,61425,60375,19596,20646,3119401
2416,43893,7192,7192,5396,5460,1796,1732,7186.0,,5923.0,,1263.0,,6998,6998,5054,4974,1944,2024,3119500
2417,43915,2857,2857,2350,2386,507,471,2846.0,,2516.0,,330.0,,2667,2667,2217,2203,450,464,3119609
2418,43931,2937,2937,2422,2461,515,476,2849.0,,2272.0,,577.0,,2875,2875,2337,2355,538,520,3119708
2419,43958,3050,3050,2281,2289,769,761,3055.0,,2590.0,,465.0,,3006,3006,2172,2103,834,903,3119807
2420,43974,4132,4132,3263,3342,869,790,4014.0,,3401.0,,613.0,,3975,3975,3060,3057,915,918,3119906
2421,43990,3530,3530,2681,2650,849,880,3567.0,,3145.0,,422.0,,3133,3133,2423,2288,710,845,3120003
2422,44016,3866,3866,2771,2757,1095,1109,3809.0,,2980.0,,829.0,,3856,3856,2636,2574,1220,1282,3120102
2423,44032,8407,8407,6673,6811,1734,1596,8320.0,,6754.0,,1566.0,,8264,8264,6351,6431,1913,1833,3120201
2424,44059,5147,5147,3631,3634,1516,1513,5028.0,,4003.0,,1025.0,,5151,5151,3441,3294,1710,1857,3120300
2425,44075,4426,4426,3663,3695,763,731,4365.0,,3756.0,,609.0,,4352,4352,3636,3565,716,787,3120409
2426,44091,8252,8252,6358,6488,1894,1764,8165.0,,6380.0,,1785.0,,8295,8295,6325,6253,1970,2042,3120508
2427,44113,5387,5387,4200,4272,1187,1115,5347.0,,4537.0,,810.0,,5087,5087,3996,3902,1091,1185,3120607
2428,44130,3901,3901,3180,3274,721,627,3840.0,,3597.0,,243.0,,4063,4063,3085,3021,978,1042,3120706
2429,44156,12982,12982,10078,10257,2904,2725,12639.0,,9532.0,,3107.0,,12638,12638,9657,9620,2981,3018,3120805
2430,44172,60160,60160,46031,46780,14129,13380,58468.0,,43526.0,,14942.0,,58048,58048,44778,44156,13270,13892,3120904
2431,44199,4999,4999,3732,3781,1267,1218,4882.0,,4019.0,,863.0,,4771,4771,3414,3394,1357,1377,3121001
2432,44210,6716,6716,5324,5456,1392,1260,6701.0,,5397.0,,1304.0,,6811,6811,5391,5382,1420,1429,3121100
2433,44237,6199,6199,4589,4745,1610,1454,6158.0,,5038.0,,1120.0,,6146,6146,4348,4346,1798,1800,3121209
2434,44253,4468,4468,3590,3678,878,790,4484.0,,3746.0,,738.0,,4500,4500,3620,3556,880,944,3121308
2435,44270,6127,6127,4985,5088,1142,1039,6046.0,,5157.0,,889.0,,5915,5915,4803,4762,1112,1153,3121407
2436,44296,3559,3559,3051,3048,508,511,3446.0,,3149.0,,297.0,,3262,3262,2732,2669,530,593,3121506
2437,44318,38097,38097,28653,28930,9444,9167,36884.0,,26977.0,,9907.0,,36508,36508,26559,26202,9949,10306,3121605
2438,44334,3751,3751,2991,2996,760,755,3679.0,,3152.0,,527.0,,3616,3616,2966,2880,650,736,3121704
2439,44350,6954,6954,4920,5042,2034,1912,6948.0,,5304.0,,1644.0,,7113,7113,4796,4541,2317,2572,3121803
2440,44377,4522,4522,3657,3716,865,806,4384.0,,3872.0,,512.0,,4026,4026,3270,3137,756,889,3121902
2441,44393,15893,15893,11821,12209,4072,3684,15611.0,,11604.0,,4007.0,,15672,15672,11129,11097,4543,4575,3122009
2442,44415,4699,4699,3196,3293,1503,1406,4648.0,,3888.0,,760.0,,4722,4722,3316,3104,1406,1618,3122108
2443,44431,6451,6451,4252,4314,2199,2137,6229.0,,4695.0,,1534.0,,6327,6327,4316,4091,2011,2236,3122207
2444,44458,170252,170252,140227,142685,30025,27567,164433.0,,126700.0,,37733.0,,163331,163331,136487,136160,26844,27171,3122306
2445,44474,4899,4899,3880,3916,1019,983,4853.0,,3806.0,,1047.0,,4931,4931,3893,3805,1038,1126,3122405
2446,44490,4129,4129,3346,3391,783,738,4884.0,,4059.0,,825.0,,4777,4777,3477,3438,1300,1339,3122504
2447,44512,4037,4037,3033,3045,1004,992,3983.0,,3137.0,,846.0,,3955,3955,2843,2756,1112,1199,3122603
2448,44539,4476,4476,3480,3557,996,919,4473.0,,3725.0,,748.0,,4571,4571,3559,3465,1012,1106,3122702
2449,44555,2880,2880,2428,2441,452,439,2845.0,,2575.0,,270.0,,2825,2825,2356,2317,469,508,3122801
2450,44571,5628,5628,4702,4758,926,870,5584.0,,4940.0,,644.0,,5349,5349,4490,4401,859,948,3122900
2451,44598,7823,7823,6780,6896,1043,927,7633.0,,6846.0,,787.0,,7640,7640,6620,6561,1020,1079,3123007
2452,44610,5140,5140,3719,3788,1421,1352,5151.0,,4223.0,,928.0,,5034,5034,3624,3468,1410,1566,3123106
2453,44636,11337,11337,8119,8377,3218,2960,11436.0,,8658.0,,2778.0,,11487,11487,8246,8102,3241,3385,3123205
2454,44652,5225,5225,3994,4056,1231,1169,5153.0,,4495.0,,658.0,,5063,5063,3797,3615,1266,1448,3123304
2455,44679,2264,2264,1558,1588,706,676,2248.0,,2047.0,,201.0,,1910,1910,1320,1238,590,672,3123403
2456,44695,1991,1991,1643,1645,348,346,1949.0,,1833.0,,116.0,,1856,1856,1499,1459,357,397,3123502
2457,44717,20005,20005,16030,16175,3975,3830,19891.0,,15772.0,,4119.0,,20074,20074,16142,16124,3932,3950,3123601
2458,44733,7826,7826,5421,5530,2405,2296,7695.0,,6081.0,,1614.0,,7739,7739,5646,5557,2093,2182,3123700
2459,44750,6221,6221,4574,4632,1647,1589,6188.0,,5184.0,,1004.0,,6210,6210,4477,4323,1733,1887,3123809
2460,44776,12482,12482,10037,10125,2445,2357,12304.0,,10005.0,,2299.0,,12204,12204,9832,9698,2372,2506,3123908
2461,44792,15542,15542,12982,13319,2560,2223,16579.0,,13957.0,,2622.0,,16487,16487,12494,12697,3993,3790,3124005
2462,44814,52999,52999,41263,41669,11736,11330,49405.0,,37398.0,,12007.0,,47557,47557,37511,36966,10046,10591,3124104
2463,44830,17931,17931,13917,14449,4014,3482,17166.0,,13395.0,,3771.0,,17036,17036,13219,13148,3817,3888,3124203
2464,44857,23348,23348,18261,18486,5087,4862,22657.0,,18654.0,,4003.0,,22209,22209,17411,17079,4798,5130,3124302
2465,44873,5096,5096,4147,4174,949,922,4802.0,,4073.0,,729.0,,4552,4552,3770,3718,782,834,3124401
2466,44890,9267,9267,7697,7816,1570,1451,9121.0,,7575.0,,1546.0,,8885,8885,7168,7221,1717,1664,3124500
2467,44911,2777,2777,2169,2056,608,721,2795.0,,2481.0,,314.0,,2584,2584,1915,1779,669,805,3124609
2468,44938,2945,2945,2176,2178,769,767,2992.0,,2431.0,,561.0,,2959,2959,2149,2084,810,875,3124708
2469,44954,5766,5766,4470,4555,1296,1211,5778.0,,4797.0,,981.0,,5776,5776,4391,4348,1385,1428,3124807
2470,44970,9107,9107,7266,7316,1841,1791,9017.0,,7673.0,,1344.0,,8645,8645,6686,6581,1959,2064,3124906
2471,44997,4260,4260,3460,3500,800,760,4204.0,,3659.0,,545.0,,4013,4013,3153,3101,860,912,3125002
2472,45012,37091,37091,28352,28764,8739,8327,32568.0,,25070.0,,7498.0,,30017,30017,23015,22927,7002,7090,3125101
2473,45039,3146,3146,2375,2424,771,722,3235.0,,2788.0,,447.0,,2882,2882,2192,2125,690,757,3125200
2474,45055,3201,3201,2554,2491,647,710,3172.0,,2799.0,,373.0,,3090,3090,2426,2285,664,805,3125309
2475,45071,5032,5032,3344,3346,1688,1686,4946.0,,3587.0,,1359.0,,4890,4890,3168,3072,1722,1818,3125408
2476,45098,3025,3025,2123,2209,902,816,2956.0,,2329.0,,627.0,,2973,2973,2039,1973,934,1000,3125507
2477,45110,5649,5649,3842,3927,1807,1722,5636.0,,4222.0,,1414.0,,5495,5495,3597,3596,1898,1899,3125606
2478,45136,11840,11840,8702,8901,3138,2939,11651.0,,8878.0,,2773.0,,11897,11897,8698,8366,3199,3531,3125705
2479,45152,2754,2754,1936,1984,818,770,2720.0,,2214.0,,506.0,,2841,2841,1976,1952,865,889,3125804
2480,45179,8669,8669,6195,6316,2474,2353,8621.0,,6443.0,,2178.0,,8781,8781,6244,6024,2537,2757,3125903
2481,45195,6644,6644,5298,5377,1346,1267,6381.0,,5138.0,,1243.0,,6224,6224,4920,4852,1304,1372,3126000
2482,45217,54947,54947,43190,43993,11757,10954,54268.0,,40843.0,,13425.0,,54620,54620,42644,42287,11976,12333,3126109
2483,45233,5849,5849,4482,4543,1367,1306,5729.0,,4808.0,,921.0,,5809,5809,4327,4153,1482,1656,3126208
2484,45250,3299,3299,2343,2421,956,878,3336.0,,2637.0,,699.0,,3423,3423,2422,2400,1001,1023,3126307
2485,45276,2634,2634,2272,2215,362,419,2910.0,,2509.0,,401.0,,2825,2825,2231,2165,594,660,3126406
2486,45292,7252,7252,4628,4670,2624,2582,7296.0,,5351.0,,1945.0,,7319,7319,4489,4305,2830,3014,3126505
2487,45314,4177,4177,3116,3155,1061,1022,4032.0,,3598.0,,434.0,,4558,4558,2960,2819,1598,1739,3126604
2488,45330,19577,19577,14408,14701,5169,4876,18994.0,,14613.0,,4381.0,,19115,19115,13970,13342,5145,5773,3126703
2489,45357,5355,5355,3909,3913,1446,1442,5348.0,,4207.0,,1141.0,,5107,5107,3578,3313,1529,1794,3126802
2490,45373,6964,6964,4940,5025,2024,1939,6939.0,,5430.0,,1509.0,,7002,7002,5057,4861,1945,2141,3126901
2491,45390,10350,10350,7918,8076,2432,2274,10298.0,,8463.0,,1835.0,,10029,10029,7497,7450,2532,2579,3127008
2492,45411,41995,41995,30962,32301,11033,9694,40751.0,,29289.0,,11462.0,,41407,41407,30250,30108,11157,11299,3127107
2493,45438,4931,4931,3886,3842,1045,1089,4915.0,,4209.0,,706.0,,4391,4391,3439,3224,952,1167,3127206
2494,45454,5477,5477,3766,3866,1711,1611,5423.0,,4291.0,,1132.0,,5403,5403,3783,3663,1620,1740,3127305
2495,45470,4018,4018,3039,3118,979,900,3929.0,,2967.0,,962.0,,3942,3942,2966,2970,976,972,3127404
2496,45497,4875,4875,3133,3184,1742,1691,4695.0,,3345.0,,1350.0,,4804,4804,3219,3143,1585,1661,3127503
2497,45519,10588,10588,7919,7928,2669,2660,10531.0,,8300.0,,2231.0,,10434,10434,7510,7259,2924,3175,3127602
2498,45535,215631,215631,152998,156183,62633,59448,213886.0,213886.0,145426.0,137715.0,68460.0,76171.0,205896,205896,150419,148618,55477,57278,3127701
2499,45551,11960,11960,8372,8542,3588,3418,11778.0,,9019.0,,2759.0,,12084,12084,8078,7798,4006,4286,3127800
2500,45578,1648,1648,1300,1354,348,294,1661.0,,1524.0,,137.0,,1609,1609,1242,1222,367,387,3127909
2501,45594,25164,25164,17483,17789,7681,7375,24152.0,,17314.0,,6838.0,,25038,25038,17410,17104,7628,7934,3128006
2502,45616,10870,10870,8310,8468,2560,2402,10775.0,,8612.0,,2163.0,,10709,10709,8068,8039,2641,2670,3128105
2503,45632,8278,8278,6300,6463,1978,1815,8375.0,,6891.0,,1484.0,,8341,8341,6253,6047,2088,2294,3128204
2504,45659,15372,15372,11763,12104,3609,3268,15257.0,,12007.0,,3250.0,,15296,15296,11587,11646,3709,3650,3128303
2505,45675,6986,6986,5505,5548,1481,1438,6990.0,,5624.0,,1366.0,,7164,7164,5424,5388,1740,1776,3128402
2506,45691,3555,3555,2795,2802,760,753,3571.0,,3008.0,,563.0,,3547,3547,2699,2632,848,915,3128501
2507,45713,5929,5929,4391,4432,1538,1497,5974.0,,4802.0,,1172.0,,5847,5847,4246,3988,1601,1859,3128600
2508,45730,38830,38830,29912,30778,8918,8052,38248.0,,28753.0,,9495.0,,38604,38604,29784,29581,8820,9023,3128709
2509,45756,6413,6413,5269,5360,1144,1053,6322.0,,5461.0,,861.0,,5993,5993,5061,5022,932,971,3128808
2510,45772,6932,6932,5346,5482,1586,1450,6904.0,,5680.0,,1224.0,,6558,6558,5023,4961,1535,1597,3128907
2511,45799,7238,7238,5958,6114,1280,1124,7171.0,,6189.0,,982.0,,7086,7086,5890,5864,1196,1222,3129004
2512,45810,5008,5008,3628,3680,1380,1328,5161.0,,4086.0,,1075.0,,5050,5050,3594,3392,1456,1658,3129103
2513,45837,5125,5125,4196,4259,929,866,5130.0,,4303.0,,827.0,,5163,5163,4216,4196,947,967,3129202
2514,45853,8555,8555,6211,6374,2344,2181,8474.0,,6672.0,,1802.0,,8468,8468,6435,6309,2033,2159,3129301
2515,45870,4989,4989,3898,4024,1091,965,4893.0,,4253.0,,640.0,,4778,4778,3761,3689,1017,1089,3129400
2516,45896,17222,17222,12683,13019,4539,4203,17059.0,,12504.0,,4555.0,,17263,17263,12127,12197,5136,5066,3129509
2517,45918,6579,6579,4490,4523,2089,2056,6625.0,,5191.0,,1434.0,,6447,6447,4406,4127,2041,2320,3129608
2518,45934,9122,9122,7091,7302,2031,1820,8983.0,,7202.0,,1781.0,,9042,9042,6922,6823,2120,2219,3129707
2519,45950,125531,125531,101574,102898,23957,22633,121310.0,,97221.0,,24089.0,,115497,115497,95823,94683,19674,20814,3129806
2520,45977,3327,3327,2678,2725,649,602,3198.0,,2598.0,,600.0,,3208,3208,2593,2575,615,633,3129905
2521,45993,2569,2569,2025,2056,544,513,2535.0,,2172.0,,363.0,,2535,2535,1922,1880,613,655,3130002
2522,46019,31911,31911,25272,25603,6639,6308,29832.0,,23447.0,,6385.0,,29134,29134,23189,22969,5945,6165,3130101
2523,46035,8095,8095,6562,6689,1533,1406,8125.0,,6878.0,,1247.0,,7427,7427,5989,5892,1438,1535,3130200
2524,46051,6469,6469,5015,5122,1454,1347,6588.0,,5651.0,,937.0,,6626,6626,5026,4949,1600,1677,3130309
2525,46078,5399,5399,4523,4548,876,851,5253.0,,4494.0,,759.0,,5195,5195,4420,4393,775,802,3130408
2526,46094,9831,9831,7782,7991,2049,1840,9639.0,,7852.0,,1787.0,,9654,9654,7709,7525,1945,2129,3130507
2527,46116,6369,6369,5126,5239,1243,1130,6343.0,,5301.0,,1042.0,,6391,6391,5097,5113,1294,1278,3130606
2528,46132,4878,4878,3927,3983,951,895,4792.0,,4166.0,,626.0,,4650,4650,3592,3473,1058,1177,3130705
2529,46159,2478,2478,2136,2140,342,338,2347.0,,2215.0,,132.0,,2955,2955,2305,2213,650,742,3130804
2530,46175,20199,20199,14996,15346,5203,4853,20064.0,,16367.0,,3697.0,,19813,19813,14486,14046,5327,5767,3130903
2531,46191,5731,5731,4628,4710,1103,1021,5713.0,,4926.0,,787.0,,5353,5353,4146,4149,1207,1204,3131000
2532,46213,6289,6289,4799,4800,1490,1489,6122.0,,4933.0,,1189.0,,6042,6042,4562,4393,1480,1649,3131109
2533,46230,15579,15579,11433,11650,4146,3929,15182.0,,11406.0,,3776.0,,15101,15101,10757,10556,4344,4545,3131208
2534,46256,179843,179843,138346,140859,41497,38984,174327.0,,129049.0,,45278.0,,183677,183677,140324,138151,43353,45526,3131307
2535,46272,3699,3699,2712,2820,987,879,3746.0,,3336.0,,410.0,,3446,3446,2561,2370,885,1076,3131406
2536,46299,7757,7757,6301,6410,1456,1347,7659.0,,6387.0,,1272.0,,7748,7748,6247,6259,1501,1489,3131505
2537,46310,6101,6101,4997,5154,1104,947,6104.0,,5511.0,,593.0,,5643,5643,4695,4693,948,950,3131604
2538,46337,91280,91280,74867,75663,16413,15617,91060.0,,73775.0,,17285.0,,90150,90150,72602,72563,17548,17587,3131703
2539,46353,8159,8159,6275,6361,1884,1798,8890.0,,7315.0,,1575.0,,8645,8645,6315,6143,2330,2502,3131802
2540,46370,42938,42938,34596,34803,8342,8135,41426.0,,32575.0,,8851.0,,40716,40716,33328,32954,7388,7762,3131901
2541,46396,4600,4600,3533,3439,1067,1161,4508.0,,4141.0,,367.0,,4889,4889,3437,2951,1452,1938,3132008
2542,46418,13709,13709,9381,9487,4328,4222,13483.0,,9961.0,,3522.0,,13607,13607,9417,9167,4190,4440,3132107
2543,46434,10858,10858,8820,8959,2038,1899,10582.0,,8376.0,,2206.0,,10416,10416,8625,8594,1791,1822,3132206
2544,46450,9296,9296,6076,6229,3220,3067,9175.0,,6818.0,,2357.0,,8837,8837,5886,5898,2951,2939,3132305
2545,46477,73509,73509,56980,58478,16529,15031,73324.0,,54505.0,,18819.0,,72708,72708,57244,56549,15464,16159,3132404
2546,46493,25736,25736,19326,19771,6410,5965,24865.0,,18800.0,,6065.0,,24783,24783,17800,17584,6983,7199,3132503
2547,46515,3650,3650,2939,2949,711,701,3650.0,,3153.0,,497.0,,3685,3685,2903,2846,782,839,3132602
2548,46531,18523,18523,12292,12431,6231,6092,18217.0,,12773.0,,5444.0,,18269,18269,12090,11447,6179,6822,3132701
2549,46558,2491,2491,2018,2031,473,460,2390.0,,2208.0,,182.0,,2552,2552,1905,1784,647,768,3132800
2550,46574,9338,9338,7134,7289,2204,2049,9352.0,,7587.0,,1765.0,,9440,9440,6806,6794,2634,2646,3132909
2551,46590,11959,11959,9500,9745,2459,2214,11658.0,,9069.0,,2589.0,,11514,11514,8988,9024,2526,2490,3133006
2552,46612,12505,12505,9944,10119,2561,2386,12266.0,,9654.0,,2612.0,,12242,12242,9742,9660,2500,2582,3133105
2553,46639,9673,9673,6852,6971,2821,2702,9369.0,,7384.0,,1985.0,,10028,10028,7166,7052,2862,2976,3133204
2554,46655,16463,16463,11704,11765,4759,4698,16156.0,,11775.0,,4381.0,,16540,16540,11226,11052,5314,5488,3133303
2555,46671,10303,10303,7902,8076,2401,2227,10238.0,,8148.0,,2090.0,,10273,10273,7790,7665,2483,2608,3133402
2556,46698,17900,17900,14533,14761,3367,3139,17922.0,,14479.0,,3443.0,,17681,17681,14049,13890,3632,3791,3133501
2557,46710,8506,8506,6469,6779,2037,1727,7726.0,,5908.0,,1818.0,,7313,7313,5694,5827,1619,1486,3133600
2558,46736,10523,10523,8340,8396,2183,2127,10061.0,,8134.0,,1927.0,,9598,9598,7569,7502,2029,2096,3133709
2559,46752,71333,71333,57321,58381,14012,12952,69772.0,,53003.0,,16769.0,,69448,69448,56065,55876,13383,13572,3133808
2560,46779,5634,5634,4658,4735,976,899,5536.0,,4783.0,,753.0,,5711,5711,4495,4398,1216,1313,3133907
2561,46795,11302,11302,7783,7885,3519,3417,11124.0,,8113.0,,3011.0,,11203,11203,7520,7404,3683,3799,3134004
2562,46817,4962,4962,3759,4021,1203,941,4882.0,,4189.0,,693.0,,4693,4693,3773,3677,920,1016,3134103
2563,46833,77325,77325,58644,59872,18681,17453,76289.0,,55333.0,,20956.0,,77181,77181,57567,56931,19614,20250,3134202
2564,46850,6029,6029,4755,4834,1274,1195,5996.0,,4732.0,,1264.0,,5955,5955,4718,4683,1237,1272,3134301
2565,46876,30194,30194,22705,23295,7489,6899,29950.0,,22893.0,,7057.0,,29461,29461,22012,21842,7449,7619,3134400
2566,46892,3756,3756,2985,3012,771,744,3740.0,,3093.0,,647.0,,3739,3739,2928,2923,811,816,3134509
2567,46914,15064,15064,11952,12098,3112,2966,14420.0,,11492.0,,2928.0,,14267,14267,11365,11113,2902,3154,3134608
2568,46930,9253,9253,6597,6665,2656,2588,8999.0,,6720.0,,2279.0,,8974,8974,6126,5881,2848,3093,3134707
2569,46957,6420,6420,4705,4928,1715,1492,6386.0,,4827.0,,1559.0,,6500,6500,4785,4657,1715,1843,3134806
2570,46973,18964,18964,14602,14962,4362,4002,18297.0,,13727.0,,4570.0,,18094,18094,14018,14027,4076,4067,3134905
2571,46990,3146,3146,2505,2527,641,619,3142.0,,2616.0,,526.0,,3126,3126,2483,2363,643,763,3135001
2572,47015,53098,53098,40986,41523,12112,11575,51586.0,,39206.0,,12380.0,,51820,51820,38547,37998,13273,13822,3135100
2573,47031,50661,50661,35491,35827,15170,14834,49029.0,,34552.0,,14477.0,,49524,49524,34219,33579,15305,15945,3135209
2574,47058,3496,3496,2930,2952,566,544,3384.0,,3022.0,,362.0,,3348,3348,2807,2774,541,574,3135308
2575,47074,5990,5990,4851,4862,1139,1128,5997.0,,5152.0,,845.0,,5809,5809,4574,4508,1235,1301,3135407
2576,47090,10383,10383,7729,7781,2654,2602,10292.0,,8253.0,,2039.0,,10293,10293,7420,7156,2873,3137,3135506
2577,47112,6674,6674,4522,4586,2152,2088,6780.0,,5206.0,,1574.0,,6641,6641,4393,4227,2248,2414,3135605
2578,47139,5805,5805,4628,4648,1177,1157,5801.0,,5014.0,,787.0,,5646,5646,4376,4240,1270,1406,3135704
2579,47155,18232,18232,12479,12608,5753,5624,17602.0,,12158.0,,5444.0,,17862,17862,11645,11365,6217,6497,3135803
2580,47171,4259,4259,3321,3377,938,882,4119.0,,3321.0,,798.0,,4216,4216,3307,3256,909,960,3135902
2581,47198,10931,10931,7347,7493,3584,3438,10954.0,,7892.0,,3062.0,,10867,10867,7014,6892,3853,3975,3136009
2582,47210,5039,5039,3575,3651,1464,1388,5148.0,,4138.0,,1010.0,,4949,4949,3458,3287,1491,1662,3136108
2583,47236,60707,60707,47995,48570,12712,12137,59727.0,,45440.0,,14287.0,,59679,59679,46717,45892,12962,13787,3136207
2584,47252,38239,38239,28273,28363,9966,9876,37322.0,,28359.0,,8963.0,,37008,37008,26709,25684,10299,11324,3136306
2585,47279,3507,3507,2482,2506,1025,1001,3426.0,,2879.0,,547.0,,3359,3359,2384,2267,975,1092,3136405
2586,47295,7705,7705,5413,5456,2292,2249,7590.0,,5528.0,,2062.0,,7923,7923,5296,5129,2627,2794,3136504
2587,47317,5567,5567,4273,4364,1294,1203,5484.0,,4247.0,,1237.0,,5439,5439,4102,3988,1337,1451,3136603
2588,47333,418213,418213,332257,337198,85956,81015,410339.0,410339.0,296356.0,290842.0,113983.0,119497.0,397841,397841,316906,314871,80935,82970,3136702
2589,47350,4478,4478,3627,3624,851,854,4461.0,,3868.0,,593.0,,4280,4280,3435,3359,845,921,3136801
2590,47376,9038,9038,7376,7597,1662,1441,8945.0,,7953.0,,992.0,,8078,8078,6596,6561,1482,1517,3136900
2591,47392,12331,12331,7923,7997,4408,4334,12579.0,,9129.0,,3450.0,,12129,12129,7747,7302,4382,4827,3137007
2592,47414,6509,6509,4978,5143,1531,1366,6533.0,,5490.0,,1043.0,,6465,6465,5022,4863,1443,1602,3137106
2593,47430,36446,36446,28515,29117,7931,7329,35228.0,,26511.0,,8717.0,,35210,35210,27584,27394,7626,7816,3137205
2594,47457,3767,3767,2645,2669,1122,1098,3844.0,,3134.0,,710.0,,3879,3879,2699,2580,1180,1299,3137304
2595,47473,10074,10074,8644,8765,1430,1309,9715.0,,8523.0,,1192.0,,9758,9758,8194,8255,1564,1503,3137403
2596,47490,14687,14687,12111,12410,2576,2277,14412.0,,12706.0,,1706.0,,14011,14011,11385,11383,2626,2628,3137502
2597,47511,49709,49709,40192,40536,9517,9173,46443.0,,35640.0,,10803.0,,44906,44906,36525,35950,8381,8956,3137601
2598,47538,14921,14921,12248,12658,2673,2263,17041.0,,14230.0,,2811.0,,16087,16087,11899,11813,4188,4274,3137700
2599,47554,16983,16983,13311,13552,3672,3431,16600.0,,12889.0,,3711.0,,16602,16602,12852,12724,3750,3878,3137809
2600,47570,3526,3526,2817,2915,709,611,3456.0,,3087.0,,369.0,,3395,3395,2656,2620,739,775,3137908
2601,47597,5596,5596,4539,4603,1057,993,5536.0,,4730.0,,806.0,,5612,5612,4516,4436,1096,1176,3138005
2602,47619,5827,5827,4215,4262,1612,1565,5806.0,,4594.0,,1212.0,,5745,5745,3976,3815,1769,1930,3138104
2603,47635,74825,74825,59440,60299,15385,14526,72492.0,,54255.0,,18237.0,,72499,72499,57794,57759,14705,14740,3138203
2604,47651,3321,3321,2635,2648,686,673,3378.0,,2929.0,,449.0,,3203,3203,2559,2499,644,704,3138302
2605,47678,41122,41122,31876,31872,9246,9250,40521.0,,30656.0,,9865.0,,40840,40840,31380,30742,9460,10098,3138401
2606,47694,4441,4441,3484,3524,957,917,4444.0,,3645.0,,799.0,,4363,4363,3373,3321,990,1042,3138500
2607,47716,14603,14603,11268,11562,3335,3041,14244.0,,11052.0,,3192.0,,14180,14180,10893,10745,3287,3435,3138609
2608,47732,4456,4456,3645,3685,811,771,4457.0,,3814.0,,643.0,,4394,4394,3536,3435,858,959,3138708
2609,47759,14861,14861,10799,11102,4062,3759,14741.0,,11006.0,,3735.0,,14775,14775,10638,10569,4137,4206,3138807
2610,47775,6038,6038,4468,4573,1570,1465,6112.0,,5010.0,,1102.0,,5801,5801,4131,3992,1670,1809,3138906
2611,47791,30277,30277,23718,24156,6559,6121,29598.0,,22008.0,,7590.0,,29849,29849,23502,23294,6347,6555,3139003
2612,47813,4343,4343,3624,3642,719,701,4280.0,,3728.0,,552.0,,4144,4144,3480,3417,664,727,3139102
2613,47830,15617,15617,10353,10578,5264,5039,15235.0,,10374.0,,4861.0,,15592,15592,9877,9637,5715,5955,3139201
2614,47856,16200,16200,11398,11458,4802,4742,15743.0,,11737.0,,4006.0,,16131,16131,11109,10722,5022,5409,3139300
2615,47872,60406,60406,46994,48303,13412,12103,58733.0,,45322.0,,13411.0,,58088,58088,45036,44702,13052,13386,3139409
2616,47899,17140,17140,12941,13110,4199,4030,16769.0,,12638.0,,4131.0,,16906,16906,12564,12316,4342,4590,3139508
2617,47910,20765,20765,14849,15228,5916,5537,20467.0,,15375.0,,5092.0,,20087,20087,14777,14437,5310,5650,3139607
2618,47937,6281,6281,5222,5286,1059,995,6253.0,,5421.0,,832.0,,6140,6140,5089,4959,1051,1181,3139706
2619,47953,10044,10044,8310,8444,1734,1600,9788.0,,8274.0,,1514.0,,9707,9707,8028,7951,1679,1756,3139805
2620,47970,12127,12127,9967,10042,2160,2085,12085.0,,9923.0,,2162.0,,12321,12321,10169,9982,2152,2339,3139904
2621,47996,50823,50823,40953,40981,9870,9842,48712.0,,38997.0,,9715.0,,48022,48022,38242,37992,9780,10030,3140001
2622,48011,4467,4467,3123,3114,1344,1353,4412.0,,3606.0,,806.0,,4009,4009,2922,2769,1087,1240,3140100
2623,48038,3007,3007,2418,2478,589,529,2962.0,,2564.0,,398.0,,2981,2981,2383,2359,598,622,3140209
2624,48054,4311,4311,3402,3458,909,853,4298.0,,3673.0,,625.0,,4186,4186,3255,3163,931,1023,3140308
2625,48070,2919,2919,2368,2399,551,520,2909.0,,2559.0,,350.0,,2806,2806,2196,2171,610,635,3140407
2626,48097,11510,11510,8640,8860,2870,2650,11302.0,,8543.0,,2759.0,,11365,11365,8364,8224,3001,3141,3140506
2627,48119,4454,4454,2804,2810,1650,1644,4503.0,,3290.0,,1213.0,,4365,4365,2707,2598,1658,1767,3140605
2628,48135,27541,27541,21229,21489,6312,6052,25720.0,,19649.0,,6071.0,,25039,25039,19345,19191,5694,5848,3140704
2629,48151,11989,11989,9611,9863,2378,2126,11731.0,,9202.0,,2529.0,,11794,11794,9531,9395,2263,2399,3140803
2630,48178,14084,14084,11405,11862,2679,2222,15767.0,,13614.0,,2153.0,,15075,15075,11632,11402,3443,3673,3140902
2631,48194,10642,10642,8632,8650,2010,1992,10399.0,,8651.0,,1748.0,,10451,10451,8179,7945,2272,2506,3141009
2632,48216,30089,30089,24128,24346,5961,5743,29527.0,,23185.0,,6342.0,,29412,29412,23829,23508,5583,5904,3141108
2633,48232,3486,3486,2529,2605,957,881,3494.0,,2848.0,,646.0,,3440,3440,2497,2501,943,939,3141207
2634,48259,3114,3114,2411,2474,703,640,3075.0,,2602.0,,473.0,,3059,3059,2283,2246,776,813,3141306
2635,48275,16217,16217,11584,11726,4633,4491,15997.0,,11951.0,,4046.0,,16282,16282,11486,11039,4796,5243,3141405
2636,48291,5244,5244,3724,3944,1520,1300,5278.0,,4375.0,,903.0,,5298,5298,3783,3766,1515,1532,3141504
2637,48313,8808,8808,6814,6932,1994,1876,8898.0,,7367.0,,1531.0,,8594,8594,6663,6509,1931,2085,3141603
2638,48330,5568,5568,3835,3945,1733,1623,5550.0,,4294.0,,1256.0,,5501,5501,3759,3601,1742,1900,3141702
2639,48356,22449,22449,13993,14295,8456,8154,21980.0,,13862.0,,8118.0,,22541,22541,13164,12820,9377,9721,3141801
2640,48372,3302,3302,2585,2626,717,676,3286.0,,2685.0,,601.0,,3322,3322,2496,2431,826,891,3141900
2641,48399,11517,11517,8526,8652,2991,2865,11417.0,,8836.0,,2581.0,,10978,10978,7813,7581,3165,3397,3142007
2642,48410,8101,8101,6588,6704,1513,1397,8012.0,,6949.0,,1063.0,,7825,7825,6328,6279,1497,1546,3142106
2643,48437,10583,10583,8116,8232,2467,2351,10643.0,,8842.0,,1801.0,,10593,10593,7829,7757,2764,2836,3142205
2644,48453,4982,4982,4233,4282,749,700,4856.0,,4359.0,,497.0,,5347,5347,4230,4120,1117,1227,3142304
2645,48470,6692,6692,5180,5315,1512,1377,6711.0,,5601.0,,1110.0,,6461,6461,4867,4781,1594,1680,3142403
2646,48496,2308,2308,1620,1652,688,656,2320.0,,1879.0,,441.0,,2321,2321,1592,1527,729,794,3142502
2647,48518,6963,6963,5461,5637,1502,1326,6773.0,,5555.0,,1218.0,,6696,6696,5305,5296,1391,1400,3142601
2648,48534,13113,13113,9000,9067,4113,4046,13005.0,,9948.0,,3057.0,,12890,12890,8829,8557,4061,4333,3142700
2649,48550,15479,15479,11212,11604,4267,3875,15305.0,,10729.0,,4576.0,,15448,15448,11226,10992,4222,4456,3142809
2650,48577,17617,17617,13888,14082,3729,3535,17317.0,,14313.0,,3004.0,,17747,17747,13617,13432,4130,4315,3142908
2651,48593,10983,10983,8522,8679,2461,2304,10917.0,,8662.0,,2255.0,,10951,10951,8427,8350,2524,2601,3143005
2652,48615,36494,36494,28171,28994,8323,7500,35524.0,,26291.0,,9233.0,,36020,36020,27406,27307,8614,8713,3143104
2653,48631,17308,17308,12757,13046,4551,4262,17028.0,,12592.0,,4436.0,,17310,17310,12491,12426,4819,4884,3143203
2654,48658,287668,287668,232938,237666,54730,50002,279274.0,,220486.0,,58788.0,,269226,269226,218043,216770,51183,52456,3143302
2655,48674,18600,18600,14572,15100,4028,3500,18260.0,,14157.0,,4103.0,,17869,17869,13804,13926,4065,3943,3143401
2656,48690,7318,7318,5481,5624,1837,1694,7474.0,,6113.0,,1361.0,,7424,7424,5201,5153,2223,2271,3143500
2657,48712,2856,2856,2135,2160,721,696,2896.0,,2578.0,,318.0,,2650,2650,1967,1853,683,797,3143609
2658,48739,3689,3689,2757,2815,932,874,3716.0,,3209.0,,507.0,,3377,3377,2560,2405,817,972,3143708
2659,48755,5939,5939,4730,4864,1209,1075,6012.0,,5092.0,,920.0,,6020,6020,4662,4659,1358,1361,3143807
2660,48771,78413,78413,63030,63633,15383,14780,77021.0,,60374.0,,16647.0,,77325,77325,61111,60157,16214,17168,3143906
2661,48798,21432,21432,16528,17025,4904,4407,21021.0,,16493.0,,4528.0,,21210,21210,16058,15541,5152,5669,3144003
2662,48810,18085,18085,13995,14235,4090,3850,17764.0,,13385.0,,4379.0,,17885,17885,13516,13631,4369,4254,3144102
2663,48836,2933,2933,1825,1898,1108,1035,3030.0,,2448.0,,582.0,,3033,3033,1936,1845,1097,1188,3144201
2664,48852,29810,29810,20643,21032,9167,8778,29715.0,,20095.0,,9620.0,,30511,30511,20265,19961,10246,10550,3144300
2665,48879,4111,4111,3242,3319,869,792,4105.0,,3365.0,,740.0,,4197,4197,3303,3266,894,931,3144409
2666,48895,6548,6548,5299,5361,1249,1187,6468.0,,5370.0,,1098.0,,6324,6324,5067,4996,1257,1328,3144508
2667,48917,20966,20966,15978,16454,4988,4512,20569.0,,15455.0,,5114.0,,20760,20760,15712,15650,5048,5110,3144607
2668,48933,15084,15084,11528,11582,3556,3502,14992.0,,11422.0,,3570.0,,15165,15165,11469,11270,3696,3895,3144706
2669,48950,76500,76500,61832,62620,14668,13880,73621.0,,58479.0,,15142.0,,69598,69598,57008,56663,12590,12935,3144805
2670,48976,3681,3681,2619,2580,1062,1101,3641.0,,3130.0,,511.0,,3440,3440,2695,2498,745,942,3144904
2671,48992,12665,12665,9569,9772,3096,2893,12241.0,,10138.0,,2103.0,,11420,11420,8512,8468,2908,2952,3145000
2672,49018,12899,12899,10451,10663,2448,2236,12606.0,,10444.0,,2162.0,,12535,12535,10131,10052,2404,2483,3145109
2673,49034,59528,59528,48511,49685,11017,9843,55656.0,,44270.0,,11386.0,,54050,54050,43939,43739,10111,10311,3145208
2674,49050,24898,24898,15213,15462,9685,9436,24440.0,,15849.0,,8591.0,,24572,24572,14387,14193,10185,10379,3145307
2675,49077,2276,2276,1796,1820,480,456,2197.0,,1933.0,,264.0,,2154,2154,1640,1647,514,507,3145406
2676,49093,2660,2660,2071,2099,589,561,2585.0,,2196.0,,389.0,,2543,2543,2023,1951,520,592,3145505
2677,49115,33473,33473,26845,27112,6628,6361,32717.0,,25407.0,,7310.0,,32885,32885,26515,25979,6370,6906,3145604
2678,49131,2427,2427,2016,2023,411,404,2322.0,,2138.0,,184.0,,2143,2143,1710,1717,433,426,3145703
2679,49158,3310,3310,2648,2652,662,658,3334.0,,3006.0,,328.0,,3194,3194,2453,2410,741,784,3145802
2680,49174,31533,31533,25658,26012,5875,5521,30993.0,,24742.0,,6251.0,,29959,29959,24387,24180,5572,5779,3145901
2681,49190,25272,25272,19369,19767,5903,5505,24769.0,,18112.0,,6657.0,,25086,25086,18913,19023,6173,6063,3146008
2682,49212,63712,63712,51924,51916,11788,11796,61409.0,,48766.0,,12643.0,,60957,60957,49421,48695,11536,12262,3146107
2683,49239,7063,7063,5058,5019,2005,2044,6976.0,,5331.0,,1645.0,,6467,6467,4424,4164,2043,2303,3146206
2684,49255,14183,14183,9357,9458,4826,4725,14024.0,,9833.0,,4191.0,,13903,13903,8914,8873,4989,5030,3146305
2685,49271,4220,4220,3255,3325,965,895,4272.0,,3632.0,,640.0,,4187,4187,3152,3098,1035,1089,3146404
2686,49298,6826,6826,5471,5580,1355,1246,6695.0,,5571.0,,1124.0,,6775,6775,5387,5352,1388,1423,3146503
2687,49310,1760,1760,1403,1396,357,364,1726.0,,1548.0,,178.0,,1686,1686,1344,1275,342,411,3146602
2688,49336,5374,5374,4182,4202,1192,1172,5384.0,,4600.0,,784.0,,5384,5384,4162,4007,1222,1377,3146701
2689,49352,3963,3963,3070,3157,893,806,3745.0,,3410.0,,335.0,,4186,4186,2732,2742,1454,1444,3127057
2690,49379,11470,11470,9623,9719,1847,1751,11407.0,,9634.0,,1773.0,,11353,11353,9301,9209,2052,2144,3146909
2691,49395,66737,66737,51200,51591,15537,15146,64349.0,,47901.0,,16448.0,,64469,64469,48382,46861,16087,17608,3147006
2692,49417,66067,66067,52829,54120,13238,11947,63804.0,,48987.0,,14817.0,,62901,62901,50079,50680,12822,12221,3147105
2693,49433,16931,16931,13185,13506,3746,3425,16944.0,,12958.0,,3986.0,,16935,16935,13363,13276,3572,3659,3147204
2694,49450,16466,16466,12884,13128,3582,3338,16273.0,,12556.0,,3717.0,,16518,16518,12747,12739,3771,3779,3147303
2695,49476,20130,20130,16363,16400,3767,3730,19800.0,,15924.0,,3876.0,,19424,19424,15685,15296,3739,4128,3147402
2696,49492,1817,1817,1430,1444,387,373,1823.0,,1627.0,,196.0,,1733,1733,1404,1327,329,406,3147501
2697,49514,13372,13372,10659,10832,2713,2540,13103.0,,10183.0,,2920.0,,13271,13271,10486,10406,2785,2865,3147600
2698,49530,7647,7647,5858,5958,1789,1689,7576.0,,5851.0,,1725.0,,7566,7566,5749,5649,1817,1917,3147709
2699,49557,2230,2230,1912,1918,318,312,2182.0,,2076.0,,106.0,,2095,2095,1683,1600,412,495,3147808
2700,49573,80821,80821,62330,63556,18491,17265,79429.0,,57676.0,,21753.0,,79983,79983,62371,61419,17612,18564,3147907
2701,49590,114130,114130,87985,90239,26145,23891,109795.0,,79560.0,,30235.0,,110852,110852,84756,84141,26096,26711,3148004
2702,49611,67804,67804,53028,54542,14776,13262,67201.0,,52480.0,,14721.0,,64198,64198,50437,49546,13761,14652,3148103
2703,49638,5181,5181,4140,4145,1041,1036,5278.0,,4506.0,,772.0,,5288,5288,4140,4016,1148,1272,3148202
2704,49654,7763,7763,6080,6114,1683,1649,7704.0,,6251.0,,1453.0,,7696,7696,5966,5863,1730,1833,3148301
2705,49670,4313,4313,3003,3023,1310,1290,4168.0,,3026.0,,1142.0,,4189,4189,2861,2810,1328,1379,3148400
2706,49697,6245,6245,4514,4575,1731,1670,6114.0,,4900.0,,1214.0,,5934,5934,4145,4106,1789,1828,3148509
2707,49719,13549,13549,9041,9236,4508,4313,13671.0,,10112.0,,3559.0,,13396,13396,8598,8088,4798,5308,3148608
2708,49735,18640,18640,12369,12406,6271,6234,18519.0,,12937.0,,5582.0,,18868,18868,12186,11772,6682,7096,3148707
2709,49751,3268,3268,2767,2812,501,456,3098.0,,2895.0,,203.0,,3593,3593,2756,2623,837,970,3148806
2710,49778,3621,3621,2935,3006,686,615,3613.0,,3181.0,,432.0,,3505,3505,2855,2836,650,669,3148905
2711,49794,2740,2740,2264,2249,476,491,2726.0,,2444.0,,282.0,,2708,2708,2093,2038,615,670,3149002
2712,49816,9497,9497,7414,7613,2083,1884,9473.0,,7295.0,,2178.0,,9647,9647,7615,7523,2032,2124,3149101
2713,49832,3146,3146,2521,2552,625,594,3217.0,,2889.0,,328.0,,3152,3152,2460,2386,692,766,3149200
2714,49859,48453,48453,39575,39994,8878,8459,47415.0,,37765.0,,9650.0,,47323,47323,38888,38429,8435,8894,3149309
2715,49875,2323,2323,1993,1998,330,325,2285.0,,2164.0,,121.0,,2116,2116,1794,1763,322,353,3149408
2716,49891,3216,3216,2548,2547,668,669,3175.0,,2672.0,,503.0,,3179,3179,2430,2371,749,808,3149507
2717,49913,3666,3666,3001,3021,665,645,3646.0,,3134.0,,512.0,,3613,3613,2836,2757,777,856,3149606
2718,49930,8062,8062,6570,6685,1492,1377,7900.0,,6514.0,,1386.0,,7869,7869,6368,6361,1501,1508,3149705
2719,49956,13571,13571,10072,10318,3499,3253,13067.0,,10178.0,,2889.0,,12526,12526,9194,8952,3332,3574,3149804
2720,49972,17270,17270,13691,13970,3579,3300,17041.0,,13317.0,,3724.0,,17092,17092,13579,13541,3513,3551,3149903
2721,49999,3588,3588,2391,2408,1197,1180,3408.0,,2580.0,,828.0,,3508,3508,2471,2378,1037,1130,3150000
2722,50016,3043,3043,2528,2548,515,495,3064.0,,2799.0,,265.0,,2779,2779,2328,2288,451,491,3150109
2723,50032,3839,3839,2956,3006,883,833,3835.0,,3192.0,,643.0,,3843,3843,2893,2815,950,1028,3150208
2724,50059,4101,4101,3105,3187,996,914,4032.0,,3201.0,,831.0,,4015,4015,2964,2956,1051,1059,3150307
2725,50075,5041,5041,3821,3968,1220,1073,4929.0,,4166.0,,763.0,,4693,4693,3606,3571,1087,1122,3150406
2726,50091,6980,6980,5580,5715,1400,1265,6893.0,,5737.0,,1156.0,,6958,6958,5442,5184,1516,1774,3150505
2727,50113,5585,5585,4888,4984,697,601,5426.0,,5006.0,,420.0,,5922,5922,4869,4776,1053,1146,3150604
2728,50130,4379,4379,3383,3475,996,904,4177.0,,3560.0,,617.0,,4101,4101,3188,3129,913,972,3150703
2729,50156,13898,13898,9792,9807,4106,4091,13672.0,,10367.0,,3305.0,,13635,13635,9137,8958,4498,4677,3150802
2730,50172,4648,4648,3699,3785,949,863,4600.0,,3708.0,,892.0,,4774,4774,3744,3752,1030,1022,3150901
2731,50199,7156,7156,5775,5881,1381,1275,6948.0,,5594.0,,1354.0,,6944,6944,5599,5588,1345,1356,3151008
2732,50210,9844,9844,8002,8084,1842,1760,9793.0,,8199.0,,1594.0,,9672,9672,7705,7687,1967,1985,3151107
2733,50237,41505,41505,31237,31754,10268,9751,40684.0,,31635.0,,9049.0,,40723,40723,30645,30316,10078,10407,3151206
2734,50253,9648,9648,7641,7887,2007,1761,9414.0,,7633.0,,1781.0,,9528,9528,7592,7547,1936,1981,3151305
2735,50270,21212,21212,17430,17578,3782,3634,20880.0,,17308.0,,3572.0,,20886,20886,17061,16818,3825,4068,3151404
2736,50296,25729,25729,19561,20287,6168,5442,25232.0,,18995.0,,6237.0,,25519,25519,19132,18996,6387,6523,3151503
2737,50318,8315,8315,6176,6349,2139,1966,8147.0,,6470.0,,1677.0,,8192,8192,6004,5939,2188,2253,3151602
2738,50334,13020,13020,10434,10749,2586,2271,12816.0,,10449.0,,2367.0,,12824,12824,10200,10352,2624,2472,3151701
2739,50350,121976,121976,91617,92937,30359,29039,117927.0,,78679.0,,39248.0,,118425,118425,88389,88205,30036,30220,3151800
2740,50377,7457,7457,5617,5728,1840,1729,7326.0,,5943.0,,1383.0,,7506,7506,5446,5151,2060,2355,3151909
2741,50393,24246,24246,18528,19091,5718,5155,23582.0,,17878.0,,5704.0,,23674,23674,17737,17698,5937,5976,3152006
2742,50415,44823,44823,36119,35681,8704,9142,43839.0,,33190.0,,10649.0,,43634,43634,35009,33713,8625,9921,3152105
2743,50431,31393,31393,23983,24461,7410,6932,30964.0,,24557.0,,6407.0,,31305,31305,22820,22843,8485,8462,3152204
2744,50458,9139,9139,7062,7158,2077,1981,8956.0,,7231.0,,1725.0,,8919,8919,6595,6531,2324,2388,3152303
2745,50474,12547,12547,8499,8627,4048,3920,12499.0,,9124.0,,3375.0,,12405,12405,8358,8160,4047,4245,3152402
2746,50490,108407,108407,86815,87721,21592,20686,103699.0,,75769.0,,27930.0,,102711,102711,82168,81444,20543,21267,3152501
2747,50512,5528,5528,4508,4555,1020,973,5488.0,,4444.0,,1044.0,,5614,5614,4516,4460,1098,1154,3152600
2748,50539,7334,7334,6195,6277,1139,1057,7061.0,,6055.0,,1006.0,,6941,6941,5765,5764,1176,1177,3152709
2749,50555,22232,22232,16206,16738,6026,5494,21699.0,,15947.0,,5752.0,,21402,21402,15446,15099,5956,6303,3152808
2750,50571,7485,7485,5799,5860,1686,1625,7488.0,,5977.0,,1511.0,,7555,7555,5787,5714,1768,1841,3152907
2751,50598,2990,2990,2350,2361,640,629,2972.0,,2508.0,,464.0,,2870,2870,2223,2182,647,688,3153004
2752,50610,5682,5682,4218,4233,1464,1449,5780.0,,5021.0,,759.0,,5472,5472,3896,3759,1576,1713,3153103
2753,50636,4109,4109,2699,2750,1410,1359,4079.0,,2986.0,,1093.0,,4206,4206,2744,2575,1462,1631,3153202
2754,50652,2923,2923,2296,2304,627,619,2861.0,,2475.0,,386.0,,2718,2718,2055,2011,663,707,3153301
2755,50679,16456,16456,12011,12362,4445,4094,16348.0,,12126.0,,4222.0,,16539,16539,11827,11631,4712,4908,3153400
2756,50695,6991,6991,5649,5763,1342,1228,6842.0,,5577.0,,1265.0,,6927,6927,5496,5491,1431,1436,3153509
2757,50717,8139,8139,6911,6934,1228,1205,7894.0,,6806.0,,1088.0,,7587,7587,6663,6558,924,1029,3153608
2758,50733,3299,3299,2737,2653,562,646,3092.0,,2888.0,,204.0,,3306,3306,2490,2334,816,972,3153707
2759,50750,2528,2528,2107,2119,421,409,2494.0,,2222.0,,272.0,,2425,2425,1946,1891,479,534,3153806
2760,50776,13332,13332,11233,11365,2099,1967,13150.0,,11345.0,,1805.0,,12753,12753,10976,10830,1777,1923,3153905
2761,50792,18151,18151,13837,13993,4314,4158,17989.0,,13976.0,,4013.0,,17958,17958,13582,13285,4376,4673,3154002
2762,50814,7937,7937,6134,6180,1803,1757,7741.0,,6422.0,,1319.0,,7737,7737,5889,5760,1848,1977,3154101
2763,50830,9415,9415,7774,7792,1641,1623,9159.0,,7355.0,,1804.0,,9172,9172,7415,7355,1757,1817,3154200
2764,50857,13103,13103,9097,9270,4006,3833,13022.0,,9430.0,,3592.0,,13267,13267,9475,9207,3792,4060,3154309
2765,50873,4248,4248,3622,3634,626,614,4183.0,,3716.0,,467.0,,4130,4130,3596,3509,534,621,3154408
2766,50890,7841,7841,5684,5635,2157,2206,7660.0,,6009.0,,1651.0,,7587,7587,5258,5139,2329,2448,3154507
2767,50911,223935,223935,175884,179034,48051,44901,214845.0,,165873.0,,48972.0,,202801,202801,164054,161820,38747,40981,3154606
2768,50938,3309,3309,2742,2764,567,545,3241.0,,2750.0,,491.0,,3254,3254,2687,2634,567,620,3154705
2769,50954,8564,8564,7081,7189,1483,1375,8502.0,,7321.0,,1181.0,,8156,8156,6845,6793,1311,1363,3154804
2770,50970,11132,11132,8025,8122,3107,3010,11256.0,,8008.0,,3248.0,,11565,11565,8093,7863,3472,3702,3154903
2771,50997,2479,2479,2035,2045,444,434,2471.0,,2158.0,,313.0,,2330,2330,1870,1840,460,490,3155009
2772,51012,4269,4269,3028,3069,1241,1200,4262.0,,3465.0,,797.0,,4285,4285,2974,2922,1311,1363,3155108
2773,51039,5602,5602,4251,4259,1351,1343,5610.0,,4835.0,,775.0,,5318,5318,4067,3930,1251,1388,3155207
2774,51055,4725,4725,3821,3867,904,858,4655.0,,3997.0,,658.0,,4583,4583,3726,3692,857,891,3155306
2775,51071,7298,7298,5716,5801,1582,1497,7169.0,,5688.0,,1481.0,,7274,7274,5562,5476,1712,1798,3155405
2776,51098,11093,11093,8105,8358,2988,2735,10994.0,,8540.0,,2454.0,,10326,10326,7383,7422,2943,2904,3155504
2777,51110,21564,21564,15772,15936,5792,5628,21041.0,,16005.0,,5036.0,,21374,21374,14993,14847,6381,6527,3155603
2778,51136,12389,12389,9566,9617,2823,2772,12352.0,,9609.0,,2743.0,,12557,12557,9538,9147,3019,3410,3155702
2779,51152,14264,14264,11330,11604,2934,2660,14260.0,,11301.0,,2959.0,,14203,14203,10930,10911,3273,3292,3155801
2780,51179,5311,5311,4173,4236,1138,1075,5175.0,,4182.0,,993.0,,5206,5206,3991,3962,1215,1244,3155900
2781,51195,10856,10856,6460,6628,4396,4228,10887.0,,6865.0,,4022.0,,11115,11115,6680,6499,4435,4616,3156007
2782,51217,4690,4690,3753,3764,937,926,4578.0,,3795.0,,783.0,,4539,4539,3566,3443,973,1096,3156106
2783,51233,2443,2443,1955,1979,488,464,2402.0,,2081.0,,321.0,,2354,2354,1824,1798,530,556,3156205
2784,51250,6676,6676,5405,5512,1271,1164,6570.0,,5540.0,,1030.0,,6392,6392,5208,5157,1184,1235,3156304
2785,51276,3179,3179,2611,2641,568,538,3169.0,,2890.0,,279.0,,2970,2970,2510,2426,460,544,3156403
2786,51292,7466,7466,4849,4926,2617,2540,7439.0,,5619.0,,1820.0,,7582,7582,4763,4400,2819,3182,3156502
2787,51314,6898,6898,4935,4965,1963,1933,6618.0,,5126.0,,1492.0,,6533,6533,4575,4368,1958,2165,3156601
2788,51330,97926,97926,78033,79349,19893,18577,95344.0,,73975.0,,21369.0,,92227,92227,74896,74460,17331,17767,3156700
2789,51357,12708,12708,8353,8496,4355,4212,12465.0,,8412.0,,4053.0,,12724,12724,8221,8123,4503,4601,3156809
2790,51373,20064,20064,15447,15672,4617,4392,19514.0,,14797.0,,4717.0,,19443,19443,14618,14490,4825,4953,3156908
2791,51390,32562,32562,24140,24739,8422,7823,31832.0,,24087.0,,7745.0,,31724,31724,23325,23162,8399,8562,3157005
2792,51411,4963,4963,3594,3613,1369,1350,4982.0,,3914.0,,1068.0,,4829,4829,3447,3288,1382,1541,3157104
2793,51438,23849,23849,19255,19501,4594,4348,23294.0,,18740.0,,4554.0,,23164,23164,18752,18497,4412,4667,3157203
2794,51454,4443,4443,3534,3603,909,840,4376.0,,3819.0,,557.0,,4306,4306,3493,3434,813,872,3157302
2795,51470,4865,4865,3844,3844,1021,1021,4847.0,,4065.0,,782.0,,4830,4830,3682,3601,1148,1229,3157401
2796,51497,4179,4179,2644,2738,1535,1441,4097.0,,3070.0,,1027.0,,4120,4120,2782,2681,1338,1439,3157500
2797,51519,3581,3581,2474,2375,1107,1206,3629.0,,3092.0,,537.0,,3390,3390,2183,2015,1207,1375,3157609
2798,51535,10519,10519,8467,8638,2052,1881,9797.0,,8311.0,,1486.0,,9109,9109,7254,7187,1855,1922,3157708
2799,51551,168807,168807,136936,138403,31871,30404,162938.0,,127179.0,,35759.0,,159377,159377,129893,128280,29484,31097,3157807
2800,51578,12835,12835,10387,10810,2448,2025,12726.0,,11223.0,,1503.0,,12441,12441,9794,9836,2647,2605,3157906
2801,51594,8735,8735,6862,6937,1873,1798,8644.0,,6848.0,,1796.0,,8776,8776,6708,6603,2068,2173,3158003
2802,51616,4439,4439,3059,3101,1380,1338,4467.0,,3685.0,,782.0,,4367,4367,2917,2820,1450,1547,3158102
2803,51632,12438,12438,7953,8075,4485,4363,12393.0,,9006.0,,3387.0,,12571,12571,7542,7188,5029,5383,3158201
2804,51659,5957,5957,5027,5077,930,880,5863.0,,4970.0,,893.0,,5907,5907,4959,4898,948,1009,3158300
2805,51675,3215,3215,2693,2790,522,425,3123.0,,2938.0,,185.0,,3068,3068,2671,2636,397,432,3158409
2806,51691,7402,7402,5712,5831,1690,1571,7353.0,,6348.0,,1005.0,,7395,7395,5393,5177,2002,2218,3158508
2807,51713,3370,3370,2749,2787,621,583,3361.0,,2899.0,,462.0,,3359,3359,2667,2624,692,735,3158607
2808,51730,2279,2279,1861,1880,418,399,2219.0,,1912.0,,307.0,,2182,2182,1754,1715,428,467,3158706
2809,51756,3997,3997,3142,3228,855,769,4011.0,,3404.0,,607.0,,3956,3956,3064,3003,892,953,3158805
2810,51772,7713,7713,5802,5940,1911,1773,7764.0,,6526.0,,1238.0,,7090,7090,5270,5212,1820,1878,3158904
2811,51799,5673,5673,4336,4398,1337,1275,5493.0,,4569.0,,924.0,,5035,5035,3606,3432,1429,1603,3159001
2812,51810,3760,3760,3082,3047,678,713,3724.0,,3284.0,,440.0,,3789,3789,2936,2864,853,925,3159100
2813,51837,7057,7057,5644,5755,1413,1302,7049.0,,5761.0,,1288.0,,7169,7169,5649,5656,1520,1513,3159209
2814,51853,4195,4195,3449,3505,746,690,4164.0,,3659.0,,505.0,,4147,4147,3402,3401,745,746,3159308
2815,51870,3332,3332,2610,2591,722,741,3303.0,,2842.0,,461.0,,3261,3261,2485,2342,776,919,3159407
2816,51896,5049,5049,3713,3827,1336,1222,5065.0,,4201.0,,864.0,,4896,4896,3749,3682,1147,1214,3159506
2817,51918,30996,30996,25002,25380,5994,5616,29968.0,,23124.0,,6844.0,,29994,29994,24235,24036,5759,5958,3159605
2818,51934,3295,3295,2435,2464,860,831,3324.0,,2767.0,,557.0,,3306,3306,2312,2253,994,1053,3159704
2819,51950,17328,17328,13238,13421,4090,3907,17227.0,,14069.0,,3158.0,,16990,16990,12894,12661,4096,4329,3159803
2820,51977,14059,14059,11131,11347,2928,2712,13944.0,,11305.0,,2639.0,,13587,13587,10815,10635,2772,2952,3159902
2821,51993,3590,3590,2899,2963,691,627,3604.0,,3195.0,,409.0,,3577,3577,2871,2804,706,773,3160009
2822,52019,3965,3965,3076,3094,889,871,4010.0,,3341.0,,669.0,,3967,3967,2997,2917,970,1050,3160108
2823,52035,3929,3929,2344,2377,1585,1552,3932.0,,2678.0,,1254.0,,3846,3846,2308,2213,1538,1633,3160207
2824,52051,9339,9339,6419,6508,2920,2831,9099.0,,7007.0,,2092.0,,9148,9148,6142,5973,3006,3175,3160306
2825,52078,20369,20369,16158,16511,4211,3858,19899.0,,15959.0,,3940.0,,19724,19724,15437,15186,4287,4538,3160405
2826,52094,2138,2138,1536,1601,602,537,2146.0,,1890.0,,256.0,,2038,2038,1471,1393,567,645,3160504
2827,52116,3048,3048,2134,2093,914,955,3035.0,,2586.0,,449.0,,2854,2854,2090,1900,764,954,3160603
2828,52132,38509,38509,30150,30553,8359,7956,38169.0,,28858.0,,9311.0,,39141,39141,30874,30523,8267,8618,3160702
2829,52159,4166,4166,3266,3364,900,802,4130.0,,3598.0,,532.0,,3957,3957,3228,3205,729,752,3160801
2830,52175,3591,3591,2838,2842,753,749,3514.0,,2886.0,,628.0,,3453,3453,2665,2600,788,853,3160900
2831,52191,14248,14248,11067,11267,3181,2981,13993.0,,11041.0,,2952.0,,13958,13958,11116,10761,2842,3197,3161007
2832,52213,41458,41458,28517,29113,12941,12345,40450.0,,29054.0,,11396.0,,40595,40595,27172,26445,13423,14150,3161106
2833,52230,5954,5954,4810,4871,1144,1083,5901.0,,4917.0,,984.0,,5861,5861,4666,4482,1195,1379,3161205
2834,52256,4623,4623,3653,3725,970,898,4670.0,,4004.0,,666.0,,4703,4703,3653,3636,1050,1067,3161304
2835,52272,4000,4000,3396,3421,604,579,3971.0,,3655.0,,316.0,,4265,4265,3359,3263,906,1002,3161403
2836,52299,7096,7096,5710,5810,1386,1286,6809.0,,5557.0,,1252.0,,6659,6659,5314,5314,1345,1345,3161502
2837,52310,3955,3955,2498,2559,1457,1396,3813.0,,2842.0,,971.0,,3928,3928,2658,2547,1270,1381,3161601
2838,52337,5255,5255,4036,4103,1219,1152,5149.0,,4494.0,,655.0,,4866,4866,3646,3525,1220,1341,3161700
2839,52353,8731,8731,7008,7180,1723,1551,8594.0,,7163.0,,1431.0,,8262,8262,6733,6645,1529,1617,3161809
2840,52370,10465,10465,9107,9208,1358,1257,10072.0,,9346.0,,726.0,,10561,10561,8885,8694,1676,1867,3161908
2841,52396,19264,19264,14519,14509,4745,4755,18951.0,,14681.0,,4270.0,,18871,18871,14502,14253,4369,4618,3162005
2842,52418,29169,29169,21257,21821,7912,7348,28694.0,,20601.0,,8093.0,,26244,26244,19263,19189,6981,7055,3162104
2843,52434,6252,6252,4967,5129,1285,1123,6029.0,,4989.0,,1040.0,,6112,6112,4887,4932,1225,1180,3162203
2844,52450,3003,3003,2386,2431,617,572,3025.0,,2667.0,,358.0,,3127,3127,2442,2383,685,744,3162302
2845,52477,22632,22632,15171,15357,7461,7275,22312.0,,16287.0,,6025.0,,22613,22613,14388,13861,8225,8752,3162401
2846,52493,70311,70311,56882,57957,13429,12354,68005.0,,51609.0,,16396.0,,67429,67429,54477,54284,12952,13145,3162500
2847,52515,7261,7261,5332,5455,1929,1806,7197.0,,5952.0,,1245.0,,7085,7085,5547,5392,1538,1693,3162609
2848,52531,17294,17294,12540,12811,4754,4483,16992.0,,12768.0,,4224.0,,17022,17022,11545,11581,5477,5441,3162708
2849,52558,12799,12799,9029,9238,3770,3561,12584.0,,9446.0,,3138.0,,12567,12567,8690,8600,3877,3967,3162807
2850,52574,20589,20589,16098,16284,4491,4305,20306.0,,15496.0,,4810.0,,20446,20446,15697,15589,4749,4857,3162906
2851,52590,3969,3969,2765,2752,1204,1217,3753.0,,2937.0,,816.0,,3988,3988,2773,2593,1215,1395,3163003
2852,52612,3848,3848,2958,3039,890,809,3772.0,,3155.0,,617.0,,3570,3570,2723,2680,847,890,3163102
2853,52639,3673,3673,2969,3005,704,668,3631.0,,3018.0,,613.0,,3731,3731,3002,2967,729,764,3163201
2854,52655,3347,3347,2410,2438,937,909,3329.0,,2859.0,,470.0,,3310,3310,2484,2392,826,918,3163300
2855,52671,4749,4749,3472,3543,1277,1206,4720.0,,3637.0,,1083.0,,4715,4715,3476,3370,1239,1345,3163409
2856,52698,5338,5338,3895,3990,1443,1348,5378.0,,4330.0,,1048.0,,5111,5111,3618,3494,1493,1617,3163508
2857,52710,2777,2777,2266,2329,511,448,2710.0,,2541.0,,169.0,,2810,2810,2106,2057,704,753,3163607
2858,52736,34752,34752,26964,27270,7788,7482,33711.0,,24244.0,,9467.0,,33710,33710,25988,25685,7722,8025,3163706
2859,52752,6064,6064,5129,5153,935,911,6059.0,,5323.0,,736.0,,6007,6007,4867,4817,1140,1190,3163805
2860,52779,4257,4257,3332,3407,925,850,4265.0,,3584.0,,681.0,,4281,4281,3213,3192,1068,1089,3163904
2861,52795,6490,6490,4663,4713,1827,1777,6568.0,,4979.0,,1589.0,,6739,6739,4761,4635,1978,2104,3164001
2862,52817,4765,4765,3509,3543,1256,1222,4756.0,,3868.0,,888.0,,4583,4583,3262,3146,1321,1437,3164100
2863,52833,7177,7177,4635,4748,2542,2429,7094.0,,5337.0,,1757.0,,6901,6901,4381,4145,2520,2756,3164209
2864,52850,5636,5636,4303,4501,1333,1135,5629.0,,4612.0,,1017.0,,5699,5699,4235,4302,1464,1397,3164308
2865,52876,5708,5708,4519,4587,1189,1121,5618.0,,4705.0,,913.0,,5298,5298,4224,4151,1074,1147,3164407
2866,52892,8928,8928,5605,5717,3323,3211,9009.0,,6610.0,,2399.0,,8836,8836,5342,4993,3494,3843,3164506
2867,52914,6162,6162,5170,5260,992,902,5793.0,,5121.0,,672.0,,6948,6948,5314,5223,1634,1725,3164605
2868,52930,51088,51088,38204,38697,12884,12391,49895.0,,34905.0,,14990.0,,50334,50334,37457,36400,12877,13934,3164704
2869,52957,1875,1875,1356,1349,519,526,1885.0,,1665.0,,220.0,,1597,1597,1136,1074,461,523,3164803
2870,52973,2075,2075,1744,1761,331,314,2038.0,,1795.0,,243.0,,1977,1977,1659,1632,318,345,3164902
2871,52990,9100,9100,7440,7482,1660,1618,8741.0,,7198.0,,1543.0,,8867,8867,7270,7150,1597,1717,3165008
2872,53015,5907,5907,4469,4512,1438,1395,5832.0,,4488.0,,1344.0,,5904,5904,4356,4231,1548,1673,3165107
2873,53031,4883,4883,3994,4015,889,868,4555.0,,3816.0,,739.0,,4459,4459,3721,3685,738,774,3165206
2874,53058,5726,5726,4465,4514,1261,1212,5684.0,,4622.0,,1062.0,,5756,5756,4438,4324,1318,1432,3165305
2875,53074,5551,5551,4323,4343,1228,1208,5461.0,,4417.0,,1044.0,,5402,5402,4022,3948,1380,1454,3165404
2876,53090,5020,5020,3311,3346,1709,1674,4903.0,,3780.0,,1123.0,,4832,4832,3429,3323,1403,1509,3165503
2877,53112,2438,2438,1987,1971,451,467,2467.0,,2213.0,,254.0,,2388,2388,1942,1844,446,544,3165602
2878,53139,6842,6842,5298,5436,1544,1406,6702.0,,5473.0,,1229.0,,6563,6563,5086,5074,1477,1489,3165701
2879,53155,2232,2232,1772,1790,460,442,2193.0,,1903.0,,290.0,,2168,2168,1783,1708,385,460,3165800
2880,53171,4594,4594,3045,3139,1549,1455,4644.0,,3757.0,,887.0,,4546,4546,2838,2779,1708,1767,3165909
2881,53198,5573,5573,4337,4486,1236,1087,5530.0,,4916.0,,614.0,,5473,5473,4196,4142,1277,1331,3166006
2882,53210,3269,3269,2288,2315,981,954,3265.0,,2623.0,,642.0,,3246,3246,2314,2189,932,1057,3166105
2883,53236,8240,8240,6762,6847,1478,1393,7977.0,,6801.0,,1176.0,,7939,7939,6455,6339,1484,1600,3166204
2884,53252,6612,6612,5299,5372,1313,1240,6622.0,,5825.0,,797.0,,6571,6571,5197,5146,1374,1425,3166303
2885,53279,1892,1892,1495,1513,397,379,1900.0,,1711.0,,189.0,,1797,1797,1428,1340,369,457,3166402
2886,53295,3691,3691,2339,2338,1352,1353,3695.0,,2703.0,,992.0,,3684,3684,2262,2198,1422,1486,3166501
2887,53317,1107,1107,925,853,182,254,1057.0,,993.0,,64.0,,941,941,789,688,152,253,3166600
2888,53333,5705,5705,4137,4181,1568,1524,5670.0,,4432.0,,1238.0,,5591,5591,3865,3701,1726,1890,3166709
2889,53350,9297,9297,7011,7372,2286,1925,9260.0,,7671.0,,1589.0,,8675,8675,6544,6484,2131,2191,3166808
2890,53376,6553,6553,4914,4993,1639,1560,6582.0,,4936.0,,1646.0,,6560,6560,4848,4831,1712,1729,3166907
2891,53392,2091,2091,1672,1660,419,431,2127.0,,1927.0,,200.0,,1970,1970,1609,1533,361,437,3167004
2892,53414,17304,17304,11687,11799,5617,5505,16747.0,,11255.0,,5492.0,,16991,16991,11145,10785,5846,6206,3167103
2893,53430,172585,172585,140084,142391,32501,30194,168867.0,,132075.0,,36792.0,,163539,163539,134855,133537,28684,30002,3167202
2894,53457,2542,2542,2241,2198,301,344,2686.0,,2362.0,,324.0,,2653,2653,2161,2060,492,593,3167301
2895,53473,4878,4878,3821,3845,1057,1033,4906.0,,3880.0,,1026.0,,4905,4905,3802,3787,1103,1118,3167400
2896,53490,2996,2996,2499,2466,497,530,2899.0,,2528.0,,371.0,,2747,2747,2235,2181,512,566,3167509
2897,53511,15717,15717,12129,12446,3588,3271,15148.0,,12358.0,,2790.0,,14942,14942,11170,11221,3772,3721,3167608
2898,53538,4475,4475,3175,3224,1300,1251,4377.0,,3429.0,,948.0,,4516,4516,3266,3209,1250,1307,3167707
2899,53554,5058,5058,4023,4080,1035,978,5000.0,,4051.0,,949.0,,5018,5018,3992,3956,1026,1062,3167806
2900,53570,4231,4231,3220,3340,1011,891,4248.0,,3450.0,,798.0,,4360,4360,3219,3174,1141,1186,3167905
2901,53597,26411,26411,19920,20303,6491,6108,25671.0,,19718.0,,5953.0,,25562,25562,18278,18380,7284,7182,3168002
2902,53619,4578,4578,3646,3666,932,912,4481.0,,4114.0,,367.0,,4232,4232,3295,3213,937,1019,3168101
2903,53635,1862,1862,1508,1520,354,342,1833.0,,1710.0,,123.0,,1685,1685,1383,1312,302,373,3168200
2904,53651,4760,4760,3699,3795,1061,965,4666.0,,3958.0,,708.0,,4353,4353,3345,3159,1008,1194,3168309
2905,53678,10760,10760,7532,7807,3228,2953,10645.0,,8343.0,,2302.0,,10575,10575,7660,7633,2915,2942,3168408
2906,53694,10567,10567,8376,8493,2191,2074,10486.0,,8421.0,,2065.0,,10280,10280,7863,7862,2417,2418,3168507
2907,53716,106388,106388,77228,78661,29160,27727,103744.0,,73339.0,,30405.0,,104153,104153,74644,72338,29509,31815,3168606
2908,53732,59866,59866,47348,47881,12518,11985,58880.0,,44973.0,,13907.0,,61309,61309,47336,46442,13973,14867,3168705
2909,53759,6956,6956,5712,5817,1244,1139,6802.0,,5732.0,,1070.0,,6377,6377,5133,5120,1244,1257,3168804
2910,53775,6246,6246,4392,4527,1854,1719,6257.0,,5004.0,,1253.0,,6009,6009,4155,4132,1854,1877,3168903
2911,53791,13436,13436,10797,10970,2639,2466,13423.0,,10912.0,,2511.0,,13283,13283,10642,10508,2641,2775,3169000
2912,53813,6382,6382,4962,5081,1420,1301,6038.0,,5092.0,,946.0,,5771,5771,4388,4402,1383,1369,3169109
2913,53830,7195,7195,5551,5617,1644,1578,7265.0,,5769.0,,1496.0,,7149,7149,5278,5245,1871,1904,3169208
2914,53856,57163,57163,44615,45212,12548,11951,55722.0,,42166.0,,13556.0,,56068,56068,44671,44198,11397,11870,3169307
2915,53872,45185,45185,36287,36752,8898,8433,44049.0,,34192.0,,9857.0,,44070,44070,35367,35039,8703,9031,3169406
2916,53899,5488,5488,3864,3916,1624,1572,5418.0,,4379.0,,1039.0,,5414,5414,3845,3716,1569,1698,3169505
2917,53910,20238,20238,15500,15812,4738,4426,19851.0,,15365.0,,4486.0,,19821,19821,14823,14678,4998,5143,3169604
2918,53937,15850,15850,12256,12412,3594,3438,15274.0,,12236.0,,3038.0,,15100,15100,11289,11131,3811,3969,3169703
2919,53953,4587,4587,3611,3631,976,956,4503.0,,3864.0,,639.0,,4094,4094,3136,3107,958,987,3169802
2920,53970,71921,71921,57399,58215,14522,13706,70282.0,,53078.0,,17204.0,,70582,70582,56511,55850,14071,14732,3169901
2921,53996,9458,9458,6786,6734,2672,2724,9276.0,,7476.0,,1800.0,,9062,9062,6421,6140,2641,2922,3170008
2922,54011,233247,233247,185838,188718,47409,44529,225412.0,225412.0,165362.0,161867.0,60050.0,63545.0,217575,217575,183873,183086,33702,34489,3170107
2923,54038,514413,514413,415567,421831,98846,92582,486550.0,,360437.0,,126113.0,,465767,465767,398271,394581,67496,71186,3170206
2924,54054,2656,2656,1853,1890,803,766,2678.0,,2063.0,,615.0,,2597,2597,1833,1729,764,868,3170305
2925,54070,63219,63219,48090,49816,15129,13403,61165.0,,45338.0,,15827.0,,61085,61085,47070,45898,14015,15187,3170404
2926,54097,8618,8618,6749,6778,1869,1840,8456.0,,6785.0,,1671.0,,8615,8615,6603,6537,2012,2078,3170503
2927,54119,2597,2597,1950,1961,647,636,2586.0,,2266.0,,320.0,,2321,2321,1671,1620,650,701,3170602
2928,54135,102682,102682,82851,83803,19831,18879,99159.0,,74556.0,,24603.0,,98704,98704,80449,79871,18255,18833,3170701
2929,54151,27079,27079,19789,20056,7290,7023,26730.0,,20611.0,,6119.0,,26880,26880,19088,18626,7792,8254,3170800
2930,54178,16214,16214,11038,11101,5176,5113,15838.0,,11553.0,,4285.0,,15772,15772,10411,10236,5361,5536,3170909
2931,54194,16668,16668,12608,12801,4060,3867,16367.0,,12770.0,,3597.0,,16389,16389,12390,11868,3999,4521,3171006
2932,54216,2470,2470,2100,2140,370,330,2421.0,,2190.0,,231.0,,2882,2882,2267,2213,615,669,3172202
2933,54232,3038,3038,2248,2297,790,741,3037.0,,2610.0,,427.0,,2768,2768,2020,1984,748,784,3171105
2934,54259,89390,89390,71280,72240,18110,17150,85893.0,,68044.0,,17849.0,,81120,81120,65595,64746,15525,16374,3171204
2935,54275,60660,60660,48536,49651,12124,11009,57391.0,,43969.0,,13422.0,,57142,57142,44834,44977,12308,12165,3171303
2936,54291,3679,3679,3145,3121,534,558,3607.0,,3363.0,,244.0,,3429,3429,3014,2861,415,568,3171402
2937,54313,3296,3296,2376,2353,920,943,3221.0,,2691.0,,530.0,,3000,3000,2100,1997,900,1003,3171501
2938,54330,10277,10277,6910,6834,3367,3443,10228.0,,7305.0,,2923.0,,10160,10160,6569,6301,3591,3859,3171600
2939,54356,7282,7282,5857,5948,1425,1334,7165.0,,6072.0,,1093.0,,7323,7323,5740,5641,1583,1682,3171709
2940,54372,8940,8940,6057,6151,2883,2789,8728.0,,6262.0,,2466.0,,8809,8809,6141,6055,2668,2754,3171808
2941,54399,4601,4601,3193,3251,1408,1350,4375.0,,3511.0,,864.0,,4276,4276,3139,3025,1137,1251,3171907
2942,54410,30399,30399,24382,24801,6017,5598,30078.0,,23926.0,,6152.0,,30106,30106,23983,23990,6123,6116,3172004
2943,54437,4350,4350,3107,3159,1243,1191,4431.0,,3480.0,,951.0,,4585,4585,3230,3067,1355,1518,3172103
2944,54453,12350,12350,9439,9502,2911,2848,12301.0,,9409.0,,2892.0,,12556,12556,9635,9526,2921,3030,3133758
2945,55000,15633,15633,11124,11140,4509,4493,15480.0,,11275.0,,4205.0,,15013,15013,10566,10216,4447,4797,5006002
2946,55018,3610,3610,2701,2706,909,904,3502.0,,2732.0,,770.0,,3502,3502,2613,2436,889,1066,5000252
2947,55026,5259,5259,4391,4402,868,857,5034.0,,4360.0,,674.0,,4721,4721,3792,3643,929,1078,5005251
2948,55034,5886,5886,4567,4583,1319,1303,5696.0,,4616.0,,1080.0,,5600,5600,4306,4018,1294,1582,5004809
2949,55042,3865,3865,3002,2968,863,897,3940.0,,3189.0,,751.0,,3897,3897,2899,2800,998,1097,5006259
2950,55050,4226,4226,3065,3001,1161,1225,4084.0,,3239.0,,845.0,,3734,3734,2663,2461,1071,1273,5006275
2951,55069,2466,2466,1954,1929,512,537,2467.0,,2153.0,,314.0,,2342,2342,1777,1687,565,655,5003900
2952,56006,7595,7595,6243,6252,1352,1343,7266.0,,6335.0,,931.0,,6906,6906,5903,5764,1003,1142,3204658
2953,56014,25401,25401,18673,18646,6728,6755,25289.0,,18629.0,,6660.0,,25461,25461,18508,17907,6953,7554,3200102
2954,56022,10652,10652,7928,7951,2724,2701,10492.0,,8458.0,,2034.0,,10040,10040,8049,7650,1991,2390,3200169
2955,56030,23900,23900,18491,18500,5409,5400,23434.0,,17618.0,,5816.0,,23130,23130,18011,17086,5119,6044,3200201
2956,56049,11108,11108,8419,8678,2689,2430,10952.0,,8838.0,,2114.0,,10596,10596,7677,7540,2919,3056,3202652
2957,56057,12515,12515,9735,9917,2780,2598,12294.0,,9731.0,,2563.0,,12172,12172,9607,9356,2565,2816,3200300
2958,56065,6373,6373,4571,4637,1802,1736,6228.0,,4904.0,,1324.0,,6296,6296,4738,4602,1558,1694,3200359
2959,56073,22626,22626,18872,18906,3754,3720,21659.0,,18312.0,,3347.0,,20322,20322,17678,17320,2644,3002,3200409
2960,56081,7345,7345,6145,6151,1200,1194,7024.0,,6090.0,,934.0,,6945,6945,5901,5830,1044,1115,3205150
2961,56090,6194,6194,4811,4812,1383,1382,6202.0,,5005.0,,1197.0,,6086,6086,4663,4449,1423,1637,3200508
2962,56103,13430,13430,10990,10975,2440,2455,12827.0,,10285.0,,2542.0,,12333,12333,10525,10415,1808,1918,3203346
2963,56111,72346,72346,55933,56311,16413,16035,69769.0,,51827.0,,17942.0,,69628,69628,54258,52830,15370,16798,3200607
2964,56120,31322,31322,24409,24630,6913,6692,30655.0,,24553.0,,6102.0,,28123,28123,21352,20871,6771,7252,3203320
2965,56138,8879,8879,7208,7230,1671,1649,8726.0,,7245.0,,1481.0,,8773,8773,6982,6908,1791,1865,3200706
2966,56146,10219,10219,7528,7553,2691,2666,9793.0,,7774.0,,2019.0,,9724,9724,6829,6495,2895,3229,3201159
2967,56154,23986,23986,18681,18599,5305,5387,23177.0,,18081.0,,5096.0,,22833,22833,18147,17360,4686,5473,3200805
2968,56162,9534,9534,7796,7909,1738,1625,9298.0,,7942.0,,1356.0,,9063,9063,7716,7562,1347,1501,3204955
2969,56170,33841,33841,24478,24755,9363,9086,33544.0,,24151.0,,9393.0,,33973,33973,24962,24114,9011,9859,3200904
2970,56189,20152,20152,15056,15153,5096,4999,19220.0,,14662.0,,4558.0,,19110,19110,13974,13727,5136,5383,3205010
2971,56197,10756,10756,8533,8576,2223,2180,10382.0,,8371.0,,2011.0,,10385,10385,8192,8110,2193,2275,3201001
2972,56200,6419,6419,4824,4834,1595,1585,6307.0,,5193.0,,1114.0,,6157,6157,4687,4389,1470,1768,3204252
2973,56219,7454,7454,6139,6092,1315,1362,7460.0,,6201.0,,1259.0,,7019,7019,5567,5438,1452,1581,3201100
2974,56227,12419,12419,10092,10029,2327,2390,12105.0,,10179.0,,1926.0,,11964,11964,9827,9796,2137,2168,3205176
2975,56235,141644,141644,112279,113233,29365,28411,140438.0,,105624.0,,34814.0,,138668,138668,109226,106969,29442,31699,3201209
2976,56251,272688,272688,217791,217812,54897,54876,262414.0,262414.0,194723.0,183873.0,67691.0,78541.0,259593,259593,212399,208956,47194,50637,3201308
2977,56278,29404,29404,23319,23702,6085,5702,28867.0,,21969.0,,6898.0,,28548,28548,22390,21933,6158,6615,3201407
2978,56294,92623,92623,72236,73032,20387,19591,90868.0,,66962.0,,23906.0,,89503,89503,70939,69200,18564,20303,3201506
2979,56308,8816,8816,6814,6960,2002,1856,8676.0,,7048.0,,1628.0,,8870,8870,6769,6580,2101,2290,3202256
2980,56316,23731,23731,16750,16633,6981,7098,22835.0,,16222.0,,6613.0,,22711,22711,15558,14909,7153,7802,3201605
2981,56332,10318,10318,7652,7777,2666,2541,10074.0,,7608.0,,2466.0,,9839,9839,7535,7210,2304,2629,3201704
2982,56359,4312,4312,3463,3478,849,834,4169.0,,3680.0,,489.0,,3781,3781,3094,2970,687,811,3201803
2983,56375,28582,28582,23528,23685,5054,4897,27397.0,,21719.0,,5678.0,,26943,26943,22786,22485,4157,4458,3201902
2984,56391,6156,6156,4846,4949,1310,1207,6003.0,,5153.0,,850.0,,5759,5759,4420,4391,1339,1368,3202009
2985,56413,19294,19294,14322,14332,4972,4962,19170.0,,14435.0,,4735.0,,19031,19031,14230,13556,4801,5475,3202108
2986,56430,14217,14217,11256,11231,2961,2986,14041.0,,11104.0,,2937.0,,14057,14057,11176,10838,2881,3219,3202207
2987,56456,21836,21836,16510,16781,5326,5055,21537.0,,16212.0,,5325.0,,21685,21685,16026,15482,5659,6203,3202306
2988,56472,96661,96661,74924,74522,21737,22139,92611.0,,68436.0,,24175.0,,91973,91973,71411,69778,20562,22195,3202405
2989,56499,9716,9716,7643,7638,2073,2078,9532.0,,7457.0,,2075.0,,9420,9420,7600,7405,1820,2015,3202504
2990,56502,6965,6965,5738,5806,1227,1159,6716.0,,5781.0,,935.0,,6492,6492,5308,5196,1184,1296,3202553
2991,56510,11339,11339,9187,9269,2152,2070,11208.0,,9193.0,,2015.0,,11088,11088,8957,8875,2131,2213,3202603
2992,56537,11688,11688,8965,8999,2723,2689,11509.0,,9017.0,,2492.0,,11305,11305,8893,8685,2412,2620,3202702
2993,56553,35442,35442,28174,28203,7268,7239,33544.0,,28107.0,,5437.0,,30517,30517,25132,24616,5385,5901,3202801
2994,56570,9457,9457,7499,7537,1958,1920,9295.0,,7443.0,,1852.0,,9182,9182,7493,7355,1689,1827,3202900
2995,56596,20793,20793,16072,16340,4721,4453,20597.0,,15860.0,,4737.0,,21139,21139,15617,15375,5522,5764,3203007
2996,56618,9977,9977,7773,7754,2204,2223,9822.0,,7749.0,,2073.0,,9761,9761,7678,7293,2083,2468,3203106
2997,56626,12845,12845,10237,10388,2608,2457,12650.0,,10019.0,,2631.0,,12554,12554,10417,10289,2137,2265,3203130
2998,56634,118268,118268,90853,91200,27415,27068,114152.0,,84316.0,,29836.0,,112502,112502,86793,84629,25709,27873,3203205
2999,56650,10960,10960,7557,7724,3403,3236,10784.0,,8407.0,,2377.0,,10970,10970,7836,7741,3134,3229,3203304
3000,56677,19587,19587,16119,16173,3468,3414,19194.0,,15892.0,,3302.0,,18949,18949,15731,15254,3218,3695,3203403
3001,56693,14959,14959,11150,11177,3809,3782,14684.0,,10957.0,,3727.0,,14652,14652,10593,10333,4059,4319,3203502
3002,56715,5093,5093,3946,3908,1147,1185,4965.0,,4180.0,,785.0,,4914,4914,3790,3586,1124,1328,3203601
3003,56731,14383,14383,11098,11244,3285,3139,14188.0,,10894.0,,3294.0,,14112,14112,10869,10479,3243,3633,3203700
3004,56758,11052,11052,9099,9086,1953,1966,10918.0,,8982.0,,1936.0,,11044,11044,8954,8699,2090,2345,3203809
3005,56774,39712,39712,29882,29552,9830,10160,38692.0,,28356.0,,10336.0,,38591,38591,28961,28241,9630,10350,3203908
3006,56790,16165,16165,11363,11435,4802,4730,16002.0,,11900.0,,4102.0,,16321,16321,11692,11215,4629,5106,3204005
3007,56812,18029,18029,13877,13934,4152,4095,17697.0,,13765.0,,3932.0,,17848,17848,13280,12998,4568,4850,3204104
3008,56839,17051,17051,13288,13228,3763,3823,17003.0,,13383.0,,3620.0,,16269,16269,12363,12067,3906,4202,3204203
3009,56855,12277,12277,9853,9913,2424,2364,12040.0,,10647.0,,1393.0,,10959,10959,9351,9076,1608,1883,3204302
3010,56871,8685,8685,7359,7379,1326,1306,8500.0,,7159.0,,1341.0,,8617,8617,7248,7144,1369,1473,3204401
3011,56898,10055,10055,8074,8119,1981,1936,9999.0,,8035.0,,1964.0,,9906,9906,8100,7883,1806,2023,3204500
3012,56910,20198,20198,15597,15623,4601,4575,19469.0,,14386.0,,5083.0,,19036,19036,15379,15003,3657,4033,3204609
3013,56936,25586,25586,19642,19240,5944,6346,25283.0,,19155.0,,6128.0,,25450,25450,19603,19095,5847,6355,3204708
3014,56952,8642,8642,6982,6999,1660,1643,8366.0,,6864.0,,1502.0,,7815,7815,6617,6373,1198,1442,3204807
3015,56979,88485,88485,67054,67173,21431,21312,84191.0,,61570.0,,22621.0,,82650,82650,62541,60790,20109,21860,3204906
3016,56995,349398,349398,278036,277453,71362,71945,327670.0,327670.0,241611.0,223144.0,86059.0,104526.0,320800,320800,259896,255137,60904,65663,3205002
3017,57010,51322,51322,41937,41957,9385,9365,48798.0,,39130.0,,9668.0,,47934,47934,40084,39457,7850,8477,3205101
3018,57037,336050,336050,277498,277693,58552,58357,315224.0,315224.0,235848.0,224579.0,79376.0,90645.0,298748,298748,265294,262304,33454,36444,3205200
3019,57053,264428,264428,219420,220163,45008,44265,251464.0,251464.0,187470.0,185724.0,63994.0,65740.0,247297,247297,212973,210559,34324,36738,3205309
3020,57070,10437,10437,8714,8844,1723,1593,9966.0,,8621.0,,1345.0,,9655,9655,8260,8177,1395,1478,3203353
3021,57096,18441,18441,14907,15286,3534,3155,17532.0,,14885.0,,2647.0,,16622,16622,14110,13800,2512,2822,3202454
3022,57118,15346,15346,11811,12049,3535,3297,15065.0,,11968.0,,3097.0,,15249,15249,11652,11457,3597,3792,3204351
3023,57134,22488,22488,17557,17491,4931,4997,21577.0,,17151.0,,4426.0,,21348,21348,16537,16199,4811,5149,3203056
3024,57150,18575,18575,13244,13214,5331,5361,18056.0,,13426.0,,4630.0,,18232,18232,12618,12177,5614,6055,3204054
3025,57916,9218,9218,7667,7806,1551,1412,8901.0,,7982.0,,919.0,,8501,8501,7408,7322,1093,1179,3203163
3026,57932,30247,30247,24967,24826,5280,5421,29305.0,,23587.0,,5718.0,,28768,28768,24076,23689,4692,5079,3204559
3027,57959,15725,15725,12560,12734,3165,2991,15453.0,,12046.0,,3407.0,,15468,15468,12161,11897,3307,3571,3205036
3028,57975,19086,19086,14686,15014,4400,4072,18597.0,,13713.0,,4884.0,,18174,18174,14181,13819,3993,4355,3205069
3029,57991,8588,8588,6740,6774,1848,1814,8321.0,,7061.0,,1260.0,,7869,7869,6511,6311,1358,1558,3200136
3030,58009,19175,19175,14994,15025,4181,4150,18630.0,,15561.0,,3069.0,,17728,17728,13300,12715,4428,5013,3304151
3031,58017,132701,132701,101399,101770,31302,30931,130059.0,,94001.0,,36058.0,,130537,130537,96607,94401,33930,36136,3300100
3032,58025,10860,10860,8806,8845,2054,2015,10792.0,,8782.0,,2010.0,,10322,10322,8223,8086,2099,2236,3304128
3033,58033,102815,102815,77956,77607,24859,25208,98336.0,,71772.0,,26564.0,,96162,96162,71678,69476,24484,26686,3300209
3034,58041,338714,338714,263601,267500,75113,71214,325796.0,,246114.0,,79682.0,,331087,331087,254791,252087,76296,79000,3300456
3035,58050,70548,70548,54466,54234,16082,16314,69676.0,,50443.0,,19233.0,,71243,71243,54594,53462,16649,17781,3300308
3036,58068,12126,12126,8985,9180,3141,2946,11990.0,,9842.0,,2148.0,,11443,11443,8647,8261,2796,3182,3301157
3037,58076,135565,135565,107719,108269,27846,27296,133606.0,,100596.0,,33010.0,,135177,135177,107673,106239,27504,28938,3300407
3038,58084,8667,8667,6786,6995,1881,1672,8498.0,,7132.0,,1366.0,,8141,8141,6197,6035,1944,2106,3306156
3039,58092,22364,22364,17230,17682,5134,4682,22059.0,,16823.0,,5236.0,,22117,22117,16666,16566,5451,5551,3300506
3040,58106,42262,42262,33094,32744,9168,9518,41007.0,,32547.0,,8460.0,,40733,40733,30520,29399,10213,11334,3301850
3041,58114,30430,30430,23283,23345,7147,7085,30453.0,,23537.0,,6916.0,,29726,29726,22314,21279,7412,8447,3300605
3042,58122,94389,94389,80472,80320,13917,14069,87662.0,,74755.0,,12907.0,,72971,72971,63103,64336,9868,8635,3304144
3043,58130,161759,161759,124029,124573,37730,37186,149701.0,,110191.0,,39510.0,,151452,151452,113056,109188,38396,42264,3300704
3044,58149,75271,75271,58844,58321,16427,16950,73444.0,,57414.0,,16030.0,,73693,73693,55858,54776,17835,18917,3302270
3045,58157,45775,45775,35431,35577,10344,10198,45165.0,,34859.0,,10306.0,,45318,45318,34789,33766,10529,11552,3300803
3046,58165,8100,8100,6779,6769,1321,1331,7946.0,,6919.0,,1027.0,,7628,7628,6258,6099,1370,1529,3300951
3047,58173,12344,12344,9804,9802,2540,2542,12651.0,,10726.0,,1925.0,,12172,12172,9440,9142,2732,3030,3300902
3048,58181,9727,9727,8005,8006,1722,1721,8947.0,,7375.0,,1572.0,,8961,8961,7281,7484,1680,1477,3300159
3049,58190,369468,369468,288302,283749,81166,85719,360626.0,360626.0,270753.0,251110.0,89873.0,109516.0,361248,361248,275712,267565,85536,93683,3301009
3050,58203,92586,92586,73243,74032,19343,18554,83760.0,,64337.0,,19423.0,,75978,75978,62986,62001,12992,13977,3304524
3051,58211,16002,16002,12625,12641,3377,3361,15930.0,,12617.0,,3313.0,,16188,16188,12258,11904,3930,4284,3301108
3052,58220,9824,9824,7944,7923,1880,1901,9595.0,,7790.0,,1805.0,,9615,9615,7707,7545,1908,2070,3300225
3053,58238,14756,14756,11792,11890,2964,2866,14526.0,,11823.0,,2703.0,,14421,14421,11192,10958,3229,3463,3301207
3054,58246,18114,18114,14527,14445,3587,3669,17633.0,,13903.0,,3730.0,,17410,17410,13803,13514,3607,3896,3303955
3055,58254,33894,33894,25975,25902,7919,7992,32525.0,,24221.0,,8304.0,,32004,32004,23903,23244,8101,8760,3301306
3056,58262,27083,27083,20867,20935,6216,6148,25807.0,,19589.0,,6218.0,,22858,22858,17076,16649,5782,6209,3301876
3057,58270,17828,17828,13793,13807,4035,4021,17781.0,,14087.0,,3694.0,,17416,17416,12936,12648,4480,4768,3301405
3058,58289,38863,38863,28495,28074,10368,10789,38064.0,,29775.0,,8289.0,,37049,37049,25976,24649,11073,12400,3304755
3059,58297,17243,17243,13734,13744,3509,3499,17022.0,,13598.0,,3424.0,,16682,16682,12872,12425,3810,4257,3301504
3060,58300,12875,12875,10116,9998,2759,2877,12791.0,,10746.0,,2045.0,,11933,11933,9046,8741,2887,3192,3300936
3061,58319,10006,10006,8072,8064,1934,1942,9874.0,,8396.0,,1478.0,,9698,9698,7586,7463,2112,2235,3301603
3062,58327,17737,17737,14369,14321,3368,3416,17453.0,,14799.0,,2654.0,,17085,17085,13525,13168,3560,3917,3304110
3063,58335,672121,672121,530263,535754,141858,136367,658000.0,,502547.0,,155453.0,,634781,634781,503829,495748,130952,139033,3301702
3064,58343,7364,7364,5952,5997,1412,1367,7199.0,,6270.0,,929.0,,7232,7232,5727,5688,1505,1544,3305133
3065,58351,11091,11091,9027,8977,2064,2114,11034.0,,9140.0,,1894.0,,10653,10653,8608,8398,2045,2255,3301801
3066,58360,25444,25444,20619,20421,4825,5023,24796.0,,20272.0,,4524.0,,24402,24402,19197,18762,5205,5640,3305752
3067,58378,176127,176127,138370,137918,37757,38209,171282.0,,127882.0,,43400.0,,171797,171797,132366,129893,39431,41904,3301900
3068,58386,7153,7153,5886,5777,1267,1376,7116.0,,5922.0,,1194.0,,6970,6970,5669,5352,1301,1618,3302452
3069,58394,94679,94679,74424,74054,20255,20625,91543.0,,70175.0,,21368.0,,90951,90951,70476,68950,20475,22001,3302007
3070,58408,32891,32891,25314,25254,7577,7637,30600.0,,23140.0,,7460.0,,27915,27915,21437,20635,6478,7280,3300233
3071,58416,20263,20263,15955,16069,4308,4194,20323.0,,15838.0,,4485.0,,19299,19299,15079,14693,4220,4606,3302106
3072,58424,58008,58008,46010,45987,11998,12021,56531.0,,43907.0,,12624.0,,55045,55045,42615,42560,12430,12485,3305554
3073,58432,75604,75604,57971,58249,17633,17355,74471.0,,54952.0,,19519.0,,75773,75773,56760,55426,19013,20347,3302205
3074,58440,25932,25932,20186,20301,5746,5631,25206.0,,19939.0,,5267.0,,25009,25009,19139,18726,5870,6283,3302254
3075,58459,7394,7394,5712,5708,1682,1686,7467.0,,6223.0,,1244.0,,7274,7274,5600,5973,1674,1301,3302304
3076,58467,136389,136389,108811,107590,27578,28799,133070.0,,100754.0,,32316.0,,135124,135124,106065,105057,29059,30067,3302858
3077,58475,172925,172925,131556,131183,41369,41742,164425.0,,120094.0,,44331.0,,160555,160555,119812,116584,40743,43971,3302403
3078,58491,197360,197360,155254,155031,42106,42329,193559.0,,150382.0,,43177.0,,181364,181364,138444,136559,42920,44805,3302502
3079,58513,39482,39482,29528,29087,9954,10395,37898.0,,27897.0,,10001.0,,36086,36086,27141,27111,8945,8975,3302601
3080,58530,143479,143479,114031,115034,29448,28445,121577.0,,93730.0,,27847.0,,107820,107820,83740,82802,24080,25018,3302700
3081,58556,15783,15783,12283,12271,3500,3512,15825.0,,12132.0,,3693.0,,15470,15470,11798,11549,3672,3921,3302809
3082,58572,24084,24084,18752,18688,5332,5396,23371.0,,17246.0,,6125.0,,23022,23022,17425,16885,5597,6137,3302908
3083,58599,22745,22745,17480,17471,5265,5274,22900.0,,17434.0,,5466.0,,22336,22336,16339,15870,5997,6466,3303005
3084,58610,12872,12872,9988,9984,2884,2888,12889.0,,10426.0,,2463.0,,12372,12372,9525,9293,2847,3079,3303104
3085,58637,131102,131102,104892,103436,26210,27666,130705.0,,98315.0,,32390.0,,133274,133274,106153,105025,27121,28249,3303203
3086,58653,405415,405415,327093,330480,78322,74935,391268.0,,281590.0,,109678.0,,384813,384813,316513,312706,68300,72107,3303302
3087,58670,154843,154843,119241,121048,35602,33795,151502.0,,108918.0,,42584.0,,151918,151918,115030,114126,36888,37792,3303401
3088,58696,611833,611833,485558,483810,126275,128023,586985.0,,435797.0,,151188.0,,588473,588473,459753,455936,128720,132537,3303500
3089,58718,33968,33968,26851,26869,7117,7099,33858.0,,26096.0,,7762.0,,33967,33967,26689,26215,7278,7752,3303609
3090,58734,34504,34504,26588,26481,7916,8023,33928.0,,25451.0,,8477.0,,34131,34131,25795,25178,8336,8953,3303708
3091,58750,32746,32746,25221,25292,7525,7454,31108.0,,24450.0,,6658.0,,29712,29712,21716,21423,7996,8289,3303807
3092,58777,243769,243769,185290,186881,58479,56888,240152.0,240152.0,168353.0,154531.0,71799.0,85621.0,243659,243659,184838,180861,58821,62798,3303906
3093,58793,22982,22982,18099,17967,4883,5015,22777.0,,17932.0,,4845.0,,22456,22456,17467,17085,4989,5371,3304003
3094,58815,14469,14469,10672,10766,3797,3703,14535.0,,10840.0,,3695.0,,14007,14007,10024,9803,3983,4204,3304102
3095,58831,97051,97051,75238,75812,21813,21239,94212.0,,70334.0,,23878.0,,93967,93967,72814,71478,21153,22489,3304201
3096,58858,45348,45348,36378,36289,8970,9059,45114.0,,35480.0,,9634.0,,45312,45312,35642,35173,9670,10139,3304300
3097,58874,15739,15739,12123,12183,3616,3556,15646.0,,12150.0,,3496.0,,15484,15484,11690,11385,3794,4099,3304409
3098,58890,8612,8612,6642,6750,1970,1862,8386.0,,6803.0,,1583.0,,8514,8514,6489,6356,2025,2158,3304508
3099,58912,9044,9044,7074,6986,1970,2058,8908.0,,7344.0,,1564.0,,8645,8645,6356,6168,2289,2477,3304607
3100,58939,33343,33343,25283,25594,8060,7749,33098.0,,25351.0,,7747.0,,33368,33368,25140,24511,8228,8857,3304706
3101,58955,31987,31987,23845,23979,8142,8008,31933.0,,24153.0,,7780.0,,30621,30621,22065,21442,8556,9179,3304805
3102,58971,670644,670644,519441,523557,151203,147087,663833.0,663833.0,466281.0,440606.0,197552.0,223227.0,678579,678579,526477,520515,152102,158064,3304904
3103,58998,38358,38358,30764,30267,7594,8091,36493.0,,29519.0,,6974.0,,32872,32872,27716,26780,5156,6092,3305000
3104,59013,377405,377405,290116,293235,87289,84170,376989.0,376989.0,282864.0,256496.0,94125.0,120493.0,367866,367866,282943,277555,84923,90311,3305109
3105,59030,69495,69495,54121,54038,15374,15457,66286.0,,48943.0,,17343.0,,64063,64063,48804,47408,15259,16655,3305208
3106,59056,7765,7765,6324,6192,1441,1573,7589.0,,6530.0,,1059.0,,6732,6732,5722,5506,1010,1226,3305307
3107,59072,16631,16631,12983,13072,3648,3559,16516.0,,12937.0,,3579.0,,16506,16506,12632,12331,3874,4175,3305406
3108,59099,73700,73700,56477,57052,17223,16648,67065.0,,49705.0,,17360.0,,64889,64889,48158,46206,16731,18683,3305505
3109,59110,19626,19626,14915,14813,4711,4813,19503.0,,15232.0,,4271.0,,18757,18757,13848,13312,4909,5445,3305604
3110,59137,14522,14522,11321,11848,3201,2674,14343.0,,12028.0,,2315.0,,13791,13791,10531,10560,3260,3231,3305703
3111,59153,129040,129040,99545,101435,29495,27605,125325.0,,92122.0,,33203.0,,129405,129405,96738,95400,32667,34005,3305802
3112,59170,8757,8757,7149,7183,1608,1574,8606.0,,7596.0,,1010.0,,8134,8134,6818,6694,1316,1440,3305901
3113,59196,63187,63187,49497,50100,13690,13087,62121.0,,47424.0,,14697.0,,62319,62319,48651,47576,13668,14743,3306008
3114,59218,57889,57889,42840,43216,15049,14673,57317.0,,40815.0,,16502.0,,58319,58319,43206,42323,15113,15996,3306107
3115,59234,30867,30867,23436,23299,7431,7568,30859.0,,22941.0,,7918.0,,30214,30214,22352,21625,7862,8589,3306206
3116,59250,225799,225799,179691,179522,46108,46277,222991.0,,166140.0,,56851.0,,224180,224180,177661,175206,46519,48974,3306305
3117,59277,33147,33147,24408,24290,8739,8857,31870.0,,24154.0,,7716.0,,29927,29927,21620,20633,8307,9294,3300258
3118,59293,11722,11722,8845,9033,2877,2689,11609.0,,9200.0,,2409.0,,11147,11147,8574,8251,2573,2896,3302056
3119,59315,23325,23325,18250,18226,5075,5099,22843.0,,17808.0,,5035.0,,22821,22821,17143,16696,5678,6125,3303856
3120,59331,16980,16980,12953,13390,4027,3590,16765.0,,13246.0,,3519.0,,16167,16167,12510,12178,3657,3989,3305158
3121,60011,5002621,5002621,3792068,3836494,1210553,1166127,4851887.0,4851887.0,3261010.0,3131733.0,1590877.0,1720154.0,4891885,4891885,3660299,3703523,1231586,1188362,3304557
3122,61000,7123,7123,4811,4937,2312,2186,7137.0,,5157.0,,1980.0,,7627,7627,5054,5076,2573,2551,3515350
3123,61018,27727,27727,20730,21147,6997,6580,27672.0,,18725.0,,8947.0,,27728,27728,20620,20474,7108,7254,3500105
3124,61026,2227,2227,1747,1759,480,468,2179.0,,1855.0,,324.0,,2206,2206,1764,1733,442,473,3507456
3125,61034,4310,4310,3239,3263,1071,1047,4348.0,,3505.0,,843.0,,4190,4190,3036,3034,1154,1156,3500204
3126,61042,11721,11721,9344,9399,2377,2322,11566.0,,9472.0,,2094.0,,11192,11192,8830,8805,2362,2387,3553955
3127,61050,24109,24109,18245,18501,5864,5608,23247.0,,17056.0,,6191.0,,22341,22341,17707,17648,4634,4693,3500303
3128,61069,3582,3582,2806,2817,776,765,3594.0,,2827.0,,767.0,,3753,3753,2735,2728,1018,1025,3532058
3129,61077,6331,6331,4851,4942,1480,1389,6284.0,,4761.0,,1523.0,,6385,6385,4802,4708,1583,1677,3500402
3130,61085,4561,4561,3128,3099,1433,1462,4523.0,,3227.0,,1296.0,,4397,4397,3020,2985,1377,1412,3519253
3131,61093,14928,14928,11611,11842,3317,3086,14816.0,,10821.0,,3995.0,,14444,14444,11094,11092,3350,3352,3500501
3132,61107,5910,5910,4510,4561,1400,1349,5713.0,,4593.0,,1120.0,,5493,5493,4155,4107,1338,1386,3518859
3133,61115,3976,3976,3138,3115,838,861,3825.0,,2939.0,,886.0,,3786,3786,2900,2816,886,970,3500600
3134,61123,1628,1628,1299,1280,329,348,1650.0,,1457.0,,193.0,,1662,1662,1233,1238,429,424,3513850
3135,61131,30532,30532,23350,23467,7182,7065,30093.0,,22968.0,,7125.0,,29966,29966,23069,22811,6897,7155,3500709
3136,61140,3531,3531,2648,2671,883,860,3448.0,,2616.0,,832.0,,3442,3442,2476,2444,966,998,3515194
3137,61158,4059,4059,3172,3225,887,834,4011.0,,3298.0,,713.0,,3866,3866,3011,3030,855,836,3500808
3138,61166,15383,15383,10355,10499,5028,4884,15476.0,,10732.0,,4744.0,,15752,15752,10226,10068,5526,5684,3544251
3139,61174,3194,3194,2418,2458,776,736,3249.0,,2642.0,,607.0,,3208,3208,2390,2337,818,871,3500907
3140,61182,2379,2379,1910,1932,469,447,2415.0,,2158.0,,257.0,,2338,2338,1841,1817,497,521,3514957
3141,61190,12408,12408,9908,10064,2500,2344,11968.0,,9649.0,,2319.0,,11237,11237,9402,9392,1835,1845,3501004
3142,61204,21727,21727,15326,15637,6401,6090,21796.0,,14989.0,,6807.0,,21425,21425,14802,14724,6623,6701,3520442
3143,61212,3648,3648,2796,2894,852,754,3682.0,,3039.0,,643.0,,3732,3732,2782,2809,950,923,3501103
3144,61220,14521,14521,11473,11512,3048,3009,14276.0,,11234.0,,3042.0,,14131,14131,11125,11082,3006,3049,3501152
3145,61239,3804,3804,2878,2983,926,821,3835.0,,3179.0,,656.0,,4068,4068,2974,3001,1094,1067,3501202
3146,61247,2781,2781,2220,2242,561,539,2837.0,,2451.0,,386.0,,2870,2870,2226,2185,644,685,3537156
3147,61255,19242,19242,14783,15080,4459,4162,18947.0,,14119.0,,4828.0,,18083,18083,13729,13790,4354,4293,3501301
3148,61263,17269,17269,13129,13202,4140,4067,16978.0,,13341.0,,3637.0,,15834,15834,11778,11831,4056,4003,3502754
3149,61271,2971,2971,2229,2228,742,743,2919.0,,2373.0,,546.0,,3151,3151,2298,2234,853,917,3501400
3150,61280,48327,48327,36221,36231,12106,12096,44814.0,,32404.0,,12410.0,,42873,42873,31132,30785,11741,12088,3506359
3151,61298,2719,2719,2073,2136,646,583,2715.0,,2282.0,,433.0,,2759,2759,2064,2025,695,734,3501509
3152,61301,2953,2953,2317,2324,636,629,2965.0,,2456.0,,509.0,,2996,2996,2272,2260,724,736,3552551
3153,61310,180219,180219,144210,145626,36009,34593,175416.0,,128836.0,,46580.0,,175226,175226,140975,140420,34251,34806,3501608
3154,61328,7012,7012,5663,5720,1349,1292,6951.0,,5998.0,,953.0,,6414,6414,5163,5148,1251,1266,3548054
3155,61336,28596,28596,22566,22706,6030,5890,27994.0,,21191.0,,6803.0,,27494,27494,21197,21183,6297,6311,3501707
3156,61344,3909,3909,3197,3158,712,751,3610.0,,3116.0,,494.0,,3281,3281,2810,2823,471,458,3510153
3157,61352,4943,4943,4034,4081,909,862,4969.0,,4241.0,,728.0,,4822,4822,3931,3877,891,945,3501806
3158,61360,4793,4793,3634,3723,1159,1070,4816.0,,3993.0,,823.0,,4765,4765,3522,3433,1243,1332,3505351
3159,61379,57481,57481,43903,44351,13578,13130,56932.0,,40398.0,,16534.0,,54368,54368,41322,41297,13046,13071,3501905
3160,61387,2735,2735,2154,2232,581,503,2698.0,,2285.0,,413.0,,2702,2702,2059,2045,643,657,3515129
3161,61395,4552,4552,3241,3166,1311,1386,4609.0,,3510.0,,1099.0,,4323,4323,3015,2910,1308,1413,3502002
3162,61409,3670,3670,2934,2939,736,731,3580.0,,2996.0,,584.0,,3595,3595,2791,2809,804,786,3533254
3163,61417,45643,45643,34690,35248,10953,10395,45414.0,,34182.0,,11232.0,,44347,44347,32930,32683,11417,11664,3502101
3164,61425,2042,2042,1499,1533,543,509,2062.0,,1736.0,,326.0,,2112,2112,1486,1472,626,640,3532843
3165,61433,18400,18400,13821,14061,4579,4339,18339.0,,13826.0,,4513.0,,17871,17871,13688,13761,4183,4110,3502200
3166,61441,6868,6868,5665,5793,1203,1075,6664.0,,5419.0,,1245.0,,6500,6500,5432,5416,1068,1084,3545159
3167,61450,5917,5917,4043,4034,1874,1883,5884.0,,4315.0,,1569.0,,5667,5667,3880,3782,1787,1885,3502309
3168,61468,4639,4639,3503,3580,1136,1059,4620.0,,3832.0,,788.0,,4488,4488,3297,3286,1191,1202,3555356
3169,61476,3412,3412,2673,2716,739,696,3411.0,,2895.0,,516.0,,3377,3377,2641,2648,736,729,3502408
3170,61484,24160,24160,17237,17346,6923,6814,23959.0,,16616.0,,7343.0,,23527,23527,16945,16823,6582,6704,3509254
3171,61492,28587,28587,22793,22853,5794,5734,28293.0,,21635.0,,6658.0,,29106,29106,23129,22973,5977,6133,3502507
3172,61506,4958,4958,3885,3895,1073,1063,4875.0,,4006.0,,869.0,,4725,4725,3693,3689,1032,1036,3509452
3173,61514,4016,4016,3046,3080,970,936,4025.0,,3290.0,,735.0,,4031,4031,2967,2954,1064,1077,3502606
3174,61522,1902,1902,1504,1526,398,376,1909.0,,1684.0,,225.0,,1861,1861,1412,1407,449,454,3503950
3175,61530,20502,20502,14691,14802,5811,5700,20655.0,,15218.0,,5437.0,,20378,20378,14652,14383,5726,5995,3502705
3176,61549,6928,6928,4967,5063,1961,1865,6929.0,,5035.0,,1894.0,,6863,6863,5185,5146,1678,1717,3556354
3177,61557,153442,153442,118492,120158,34950,33284,151463.0,,106602.0,,44861.0,,144287,144287,110771,110488,33516,33799,3502804
3178,61565,13037,13037,10294,10380,2743,2657,12796.0,,10299.0,,2497.0,,12195,12195,9601,9495,2594,2700,3540754
3179,61573,24804,24804,20035,20266,4769,4538,23766.0,,18191.0,,5575.0,,22608,22608,19646,19550,2962,3058,3502903
3180,61581,4933,4933,3956,4007,977,926,4746.0,,3947.0,,799.0,,4655,4655,3575,3550,1080,1105,3500758
3181,61590,4613,4613,3517,3607,1096,1006,4665.0,,3803.0,,862.0,,4597,4597,3412,3388,1185,1209,3503000
3182,61603,3058,3058,2184,2200,874,858,3057.0,,2452.0,,605.0,,3094,3094,2163,2068,931,1026,3522158
3183,61611,5821,5821,4464,4512,1357,1309,5793.0,,4674.0,,1119.0,,5873,5873,4539,4515,1334,1358,3503109
3184,61620,5518,5518,4237,4328,1281,1190,5450.0,,4274.0,,1176.0,,5401,5401,4191,4151,1210,1250,3554953
3185,61638,180856,180856,137214,139260,43642,41596,177682.0,,122434.0,,55248.0,,166651,166651,126986,126839,39665,39812,3503208
3186,61646,2485,2485,1880,1907,605,578,2503.0,,2003.0,,500.0,,2547,2547,1894,1835,653,712,3503158
3187,61654,101312,101312,80002,80992,21310,20320,99659.0,,72495.0,,27164.0,,97387,97387,77453,77639,19934,19748,3503307
3188,61662,9442,9442,7614,7627,1828,1815,9209.0,,7587.0,,1622.0,,8631,8631,6902,6893,1729,1738,3557303
3189,61670,6388,6388,4934,5005,1454,1383,6278.0,,4792.0,,1486.0,,6375,6375,4881,4874,1494,1501,3503406
3190,61689,14961,14961,11567,11727,3394,3234,14935.0,,11413.0,,3522.0,,14177,14177,10999,10909,3178,3268,3515152
3191,61697,3263,3263,2679,2661,584,602,3099.0,,2716.0,,383.0,,2938,2938,2494,2435,444,503,3503505
3192,61700,6696,6696,5191,5254,1505,1442,6568.0,,5083.0,,1485.0,,6730,6730,5181,5178,1549,1552,3543253
3193,61719,8565,8565,6764,6797,1801,1768,8532.0,,6828.0,,1704.0,,8486,8486,6611,6572,1875,1914,3503604
3194,61727,165269,165269,132600,133867,32669,31402,157960.0,,120256.0,,37704.0,,149024,149024,119363,118687,29661,30337,3519071
3195,61735,6960,6960,5419,5502,1541,1458,7031.0,,5795.0,,1236.0,,7256,7256,5574,5573,1682,1683,3503703
3196,61743,12290,12290,10172,10195,2118,2095,11751.0,,9482.0,,2269.0,,10553,10553,8607,8552,1946,2001,3519055
3197,61751,38456,38456,31239,31651,7217,6805,37609.0,,30197.0,,7412.0,,34865,34865,28389,28242,6476,6623,3503802
3198,61760,2730,2730,2223,2236,507,494,2694.0,,2351.0,,343.0,,2681,2681,2324,2300,357,381,3514924
3199,61778,71158,71158,56950,56993,14208,14165,68888.0,,51756.0,,17132.0,,66630,66630,53199,52572,13431,14058,3503901
3200,61786,3342,3342,2601,2612,741,730,3270.0,,2801.0,,469.0,,3222,3222,2398,2407,824,815,3507159
3201,61794,74117,74117,55993,57010,18124,17107,72949.0,,50238.0,,22711.0,,71685,71685,53559,53434,18126,18251,3504008
3202,61808,3288,3288,2474,2516,814,772,3336.0,,2757.0,,579.0,,3313,3313,2385,2398,928,915,3540259
3203,61816,119604,119604,92668,93519,26936,26085,114773.0,,82675.0,,32098.0,,106960,106960,82431,81819,24529,25141,3504107
3204,61824,2735,2735,2162,2191,573,544,2608.0,,2278.0,,330.0,,2433,2433,1881,1891,552,542,3536257
3205,61832,10967,10967,8831,8984,2136,1983,10752.0,,8869.0,,1883.0,,10449,10449,8644,8668,1805,1781,3504206
3206,61840,5035,5035,3898,3966,1137,1069,4959.0,,3912.0,,1047.0,,4879,4879,3690,3684,1189,1195,3553856
3207,61859,4145,4145,3143,3143,1002,1002,4038.0,,3254.0,,784.0,,4189,4189,3112,3046,1077,1143,3504305
3208,61867,2767,2767,2162,2214,605,553,2804.0,,2473.0,,331.0,,2650,2650,2079,2071,571,579,3528858
3209,61875,7915,7915,6056,6120,1859,1795,7850.0,,6108.0,,1742.0,,7877,7877,5976,5875,1901,2002,3504404
3210,61883,1722,1722,1354,1385,368,337,1649.0,,1515.0,,134.0,,1523,1523,1260,1246,263,277,3549250
3211,61891,68765,68765,51141,51771,17624,16994,67361.0,,46166.0,,21195.0,,65108,65108,49041,48584,16067,16524,3504503
3212,61905,12474,12474,9396,9466,3078,3008,12168.0,,9477.0,,2691.0,,11940,11940,9070,9013,2870,2927,3549953
3213,61913,14352,14352,11399,11585,2953,2767,13296.0,,10231.0,,3065.0,,12491,12491,9748,9694,2743,2797,3504602
3214,61921,2468,2468,1912,1936,556,532,2488.0,,2068.0,,420.0,,2451,2451,1831,1805,620,646,3557154
3215,61930,1442,1442,1069,1069,373,373,1433.0,,1196.0,,237.0,,1488,1488,1103,1062,385,426,3504701
3216,61948,3328,3328,2593,2647,735,681,3283.0,,2822.0,,461.0,,3272,3272,2442,2446,830,826,3522653
3217,61956,7490,7490,6008,6142,1482,1348,7410.0,,6210.0,,1200.0,,7189,7189,5750,5761,1439,1428,3504800
3218,61964,1784,1784,1389,1394,395,390,1775.0,,1561.0,,214.0,,1764,1764,1297,1307,467,457,3529658
3219,61972,8809,8809,6703,6722,2106,2087,8718.0,,6395.0,,2323.0,,8889,8889,6554,6538,2335,2351,3504909
3220,61980,7126,7126,5537,5566,1589,1560,7077.0,,5836.0,,1241.0,,7102,7102,5424,5307,1678,1795,3532827
3221,61999,5268,5268,4029,4078,1239,1190,5255.0,,4218.0,,1037.0,,5362,5362,3880,3794,1482,1568,3505104
3222,62006,12846,12846,8732,8765,4114,4081,12383.0,,8998.0,,3385.0,,11227,11227,7615,7454,3612,3773,3520426
3223,62014,2790,2790,2102,2145,688,645,2745.0,,2202.0,,543.0,,2725,2725,2001,2029,724,696,3505005
3224,62022,1954,1954,1473,1498,481,456,1962.0,,1665.0,,297.0,,1967,1967,1471,1465,496,502,3527256
3225,62030,25274,25274,18870,18982,6404,6292,25208.0,,17829.0,,7379.0,,25333,25333,18625,18668,6708,6665,3505203
3226,62049,2587,2587,1933,1948,654,639,2591.0,,2068.0,,523.0,,2595,2595,1799,1805,796,790,3554656
3227,62057,30177,30177,23553,23814,6624,6363,30171.0,,22983.0,,7188.0,,30312,30312,23501,23339,6811,6973,3505302
3228,62065,2252,2252,1729,1757,523,495,2263.0,,2042.0,,221.0,,2115,2115,1600,1562,515,553,3503356
3229,62073,7243,7243,4589,4615,2654,2628,7204.0,,5231.0,,1973.0,,7061,7061,4203,4101,2858,2960,3505401
3230,62081,2576,2576,2033,2041,543,535,2590.0,,2160.0,,430.0,,2659,2659,2043,2026,616,633,3507753
3231,62090,91066,91066,66310,67686,24756,23380,89968.0,,59860.0,,30108.0,,86843,86843,62109,62020,24734,24823,3505500
3232,62103,3940,3940,3094,3120,846,820,3831.0,,3246.0,,585.0,,3872,3872,3066,3041,806,831,3509957
3233,62111,24540,24540,19528,19662,5012,4878,24220.0,,19471.0,,4749.0,,23051,23051,17735,17646,5316,5405,3505609
3234,62120,1360,1360,1107,1109,253,251,1300.0,,1161.0,,139.0,,1230,1230,1028,1024,202,206,3540853
3235,62138,279389,279389,225042,224368,54347,55021,261428.0,,196045.0,,65383.0,,252040,252040,201505,200166,50535,51874,3505708
3236,62146,4906,4906,3675,3652,1231,1254,4806.0,,3805.0,,1001.0,,4507,4507,3317,3303,1190,1204,3541059
3237,62154,18091,18091,13654,13924,4437,4167,18052.0,,13567.0,,4485.0,,17586,17586,13276,13278,4310,4308,3505807
3238,62162,3809,3809,2827,2882,982,927,3736.0,,2842.0,,894.0,,3110,3110,2330,2267,780,843,3541653
3239,62170,45053,45053,34442,34791,10611,10262,44504.0,,30969.0,,13535.0,,43555,43555,32977,32825,10578,10730,3505906
3240,62189,2193,2193,1645,1660,548,533,2208.0,,1884.0,,324.0,,2116,2116,1546,1514,570,602,3546256
3241,62197,279646,279646,215729,217452,63917,62194,270749.0,270749.0,188276.0,184113.0,82473.0,86636.0,268824,268824,210190,208286,58634,60538,3506003
3242,62200,1721,1721,1411,1418,310,303,1742.0,,1562.0,,180.0,,1799,1799,1428,1407,371,392,3547650
3243,62219,60070,60070,45009,45769,15061,14301,59935.0,,41388.0,,18547.0,,58103,58103,42865,42764,15238,15339,3506102
3244,62227,1626,1626,1333,1368,293,258,1626.0,,1426.0,,200.0,,1600,1600,1289,1285,311,315,3556958
3245,62235,2161,2161,1696,1732,465,429,2174.0,,1865.0,,309.0,,2189,2189,1594,1625,595,564,3506201
3246,62243,4376,4376,3424,3440,952,936,4230.0,,3438.0,,792.0,,4201,4201,3047,3109,1154,1092,3521150
3247,62251,8456,8456,6394,6453,2062,2003,8459.0,,6417.0,,2042.0,,8419,8419,6367,6291,2052,2128,3506300
3248,62260,2296,2296,1801,1848,495,448,2299.0,,1923.0,,376.0,,2291,2291,1761,1720,530,571,3553658
3249,62278,6438,6438,5002,5141,1436,1297,6317.0,,4567.0,,1750.0,,6168,6168,5042,5050,1126,1118,3506409
3250,62286,1590,1590,1206,1239,384,351,1572.0,,1326.0,,246.0,,1547,1547,1175,1152,372,395,3515657
3251,62294,89401,89401,69499,71199,19902,18202,88550.0,,63027.0,,25523.0,,85382,85382,68034,68098,17348,17284,3506508
3252,62308,4127,4127,3251,3244,876,883,4050.0,,3406.0,,644.0,,4053,4053,3145,3107,908,946,3516853
3253,62316,24008,24008,18845,18726,5163,5282,23613.0,,18389.0,,5224.0,,23317,23317,18050,17990,5267,5327,3506607
3254,62324,2435,2435,1876,1890,559,545,2386.0,,1950.0,,436.0,,2353,2353,1788,1770,565,583,3525854
3255,62332,10473,10473,8135,8101,2338,2372,10287.0,,7971.0,,2316.0,,10170,10170,7711,7706,2459,2464,3506706
3256,62340,2333,2333,1759,1785,574,548,2332.0,,1975.0,,357.0,,2327,2327,1711,1744,616,583,3532157
3257,62359,9139,9139,7131,7131,2008,2008,9134.0,,7097.0,,2037.0,,8960,8960,6995,6954,1965,2006,3506805
3258,62367,1287,1287,1017,1026,270,261,1230.0,,1126.0,,104.0,,1155,1155,949,930,206,225,3532868
3259,62375,8615,8615,6178,6186,2437,2429,8420.0,,6273.0,,2147.0,,8011,8011,5675,5618,2336,2393,3506904
3260,62383,7527,7527,5967,6058,1560,1469,7229.0,,6021.0,,1208.0,,6780,6780,5622,5594,1158,1186,3534757
3261,62391,46475,46475,35544,36159,10931,10316,44152.0,,31786.0,,12366.0,,41664,41664,32293,32291,9371,9373,3507001
3262,62405,1908,1908,1475,1468,433,440,1849.0,,1578.0,,271.0,,1837,1837,1348,1346,489,491,3536570
3263,62413,18412,18412,14470,14565,3942,3847,17854.0,,13822.0,,4032.0,,16605,16605,13024,12967,3581,3638,3507100
3264,62421,1882,1882,1526,1543,356,339,1861.0,,1593.0,,268.0,,1800,1800,1461,1481,339,319,3543238
3265,62430,1040,1040,848,832,192,208,1061.0,,930.0,,131.0,,1123,1123,840,842,283,281,3507209
3266,62448,1588,1588,1282,1252,306,336,1574.0,,1398.0,,176.0,,1619,1619,1286,1272,333,347,3554755
3267,62456,3997,3997,3126,3120,871,877,3872.0,,3044.0,,828.0,,3705,3705,2910,2907,795,798,3507308
3268,62472,11562,11562,8752,8952,2810,2610,11659.0,,8924.0,,2735.0,,11035,11035,8241,8315,2794,2720,3507407
3269,62499,106890,106890,86716,86882,20174,20008,101025.0,,75789.0,,25236.0,,96216,96216,82711,81870,13505,14346,3507506
3270,62510,135174,135174,105388,106308,29786,28866,131200.0,,93473.0,,37727.0,,125204,125204,97495,96711,27709,28493,3507605
3271,62553,4283,4283,3453,3461,830,822,4327.0,,3595.0,,732.0,,4222,4222,3369,3349,853,873,3507704
3272,62570,18175,18175,14167,14562,4008,3613,17858.0,,13646.0,,4212.0,,16177,16177,12767,12824,3410,3353,3507803
3273,62596,18945,18945,13871,14039,5074,4906,18692.0,,13100.0,,5592.0,,18322,18322,13288,13223,5034,5099,3507902
3274,62618,15845,15845,11892,12123,3953,3722,15561.0,,12039.0,,3522.0,,15342,15342,11695,11561,3647,3781,3508009
3275,62634,13694,13694,10118,10433,3576,3261,13689.0,,10105.0,,3584.0,,13403,13403,9679,9690,3724,3713,3508108
3276,62650,3824,3824,3008,3073,816,751,3741.0,,3152.0,,589.0,,3666,3666,2922,2864,744,802,3508207
3277,62677,3400,3400,2663,2678,737,722,3372.0,,2821.0,,551.0,,3213,3213,2679,2622,534,591,3508306
3278,62693,35451,35451,28029,28237,7422,7214,33386.0,,25474.0,,7912.0,,33381,33381,26361,26260,7020,7121,3508405
3279,62715,74893,74893,58866,59313,16027,15580,73416.0,,54129.0,,19287.0,,71321,71321,55915,55655,15406,15666,3508504
3280,62731,25599,25599,19438,19607,6161,5992,25479.0,,18415.0,,7064.0,,25386,25386,19258,18993,6128,6393,3508603
3281,62758,14610,14610,10667,10927,3943,3683,14500.0,,10654.0,,3846.0,,14633,14633,10469,10367,4164,4266,3508702
3282,62774,13255,13255,9858,10009,3397,3246,13225.0,,9655.0,,3570.0,,13393,13393,9646,9623,3747,3770,3508801
3283,62790,3314,3314,2756,2799,558,515,3256.0,,2892.0,,364.0,,3220,3220,2741,2730,479,490,3508900
3284,62812,70965,70965,57049,57472,13916,13493,67960.0,,52594.0,,15366.0,,66671,66671,54018,53617,12653,13054,3509007
3285,62839,3947,3947,2951,3011,996,936,3966.0,,3237.0,,729.0,,3955,3955,2825,2799,1130,1156,3509106
3286,62855,68076,68076,54336,54526,13740,13550,64881.0,,51128.0,,13753.0,,61996,61996,49121,48940,12875,13056,3509205
3287,62871,7852,7852,6048,6173,1804,1679,7846.0,,6341.0,,1505.0,,8084,8084,6019,6007,2065,2077,3509304
3288,62898,19333,19333,14477,14675,4856,4658,19232.0,,13959.0,,5273.0,,19171,19171,13639,13671,5532,5500,3509403
3289,62910,878715,878715,685756,691455,192959,187260,843433.0,843433.0,583284.0,546136.0,260149.0,297297.0,849127,849127,660606,659012,188521,190115,3509502
3290,62936,61602,61602,48382,48543,13220,13059,60354.0,,45483.0,,14871.0,,59860,59860,47174,46955,12686,12905,3509601
3291,62952,39943,39943,29555,30009,10388,9934,39596.0,,26587.0,,13009.0,,39314,39314,27926,28057,11388,11257,3509700
3292,62979,3797,3797,2897,2936,900,861,3807.0,,3232.0,,575.0,,3764,3764,2794,2790,970,974,3509809
3293,62995,9977,9977,7745,7665,2232,2312,9343.0,,7513.0,,1830.0,,8513,8513,6945,6900,1568,1613,3509908
3294,63010,24747,24747,18691,19027,6056,5720,24660.0,,17294.0,,7366.0,,24945,24945,18750,18857,6195,6088,3510005
3295,63037,2576,2576,2008,2041,568,535,2612.0,,2234.0,,378.0,,2526,2526,1901,1889,625,637,3510104
3296,63053,36543,36543,27562,27869,8981,8674,36212.0,,25684.0,,10528.0,,36427,36427,27349,27105,9078,9322,3510203
3297,63070,14907,14907,11594,11920,3313,2987,14708.0,,11688.0,,3020.0,,13646,13646,10871,11013,2775,2633,3510302
3298,63096,39287,39287,30792,31261,8495,8026,38405.0,,28031.0,,10374.0,,37516,37516,29548,29362,7968,8154,3510401
3299,63118,104071,104071,79528,79077,24543,24994,98546.0,,71627.0,,26919.0,,91625,91625,69226,68614,22399,23011,3510500
3300,63134,300479,300479,235263,236311,65216,64168,291138.0,,208176.0,,82962.0,,290990,290990,229750,228474,61240,62516,3510609
3301,63150,10262,10262,7164,7352,3098,2910,10298.0,,7325.0,,2973.0,,10465,10465,7139,7099,3326,3366,3510708
3302,63177,20884,20884,15330,15609,5554,5275,20681.0,,14392.0,,6289.0,,20766,20766,14956,14717,5810,6049,3510807
3303,63193,2822,2822,2049,2125,773,697,2819.0,,2294.0,,525.0,,2901,2901,1995,2040,906,861,3510906
3304,63215,15758,15758,12000,12258,3758,3500,15785.0,,12502.0,,3283.0,,14664,14664,11027,10961,3637,3703,3511003
3305,63231,88190,88190,69566,70448,18624,17742,87173.0,,63013.0,,24160.0,,85817,85817,71615,71293,14202,14524,3511102
3306,63258,5822,5822,4729,4761,1093,1061,5796.0,,4875.0,,921.0,,5769,5769,4732,4709,1037,1060,3511201
3307,63274,7703,7703,6120,6255,1583,1448,7224.0,,5752.0,,1472.0,,6959,6959,5551,5506,1408,1453,3511300
3308,63290,15932,15932,11493,11583,4439,4349,15431.0,,10885.0,,4546.0,,15240,15240,11089,11125,4151,4115,3511409
3309,63312,36825,36825,28602,28857,8223,7968,36106.0,,25861.0,,10245.0,,34583,34583,27406,27410,7177,7173,3511508
3310,63339,13968,13968,10581,10745,3387,3223,13840.0,,10032.0,,3808.0,,12715,12715,9936,9942,2779,2773,3511607
3311,63355,13299,13299,10412,10558,2887,2741,13090.0,,10337.0,,2753.0,,12717,12717,10099,9973,2618,2744,3511706
3312,63371,8782,8782,7325,7348,1457,1434,8489.0,,7216.0,,1273.0,,8100,8100,7248,7125,852,975,3557204
3313,63398,5527,5527,4357,4451,1170,1076,5466.0,,4558.0,,908.0,,5489,5489,4277,4288,1212,1201,3511904
3314,63410,15025,15025,11187,11345,3838,3680,14825.0,,11204.0,,3621.0,,14812,14812,10494,10663,4318,4149,3512001
3315,63436,5835,5835,4282,4330,1553,1505,5812.0,,4814.0,,998.0,,6017,6017,4211,4132,1806,1885,3512100
3316,63452,22084,22084,17729,17935,4355,4149,21972.0,,17602.0,,4370.0,,20449,20449,16414,16315,4035,4134,3512209
3317,63479,13794,13794,9814,10104,3980,3690,13614.0,,9386.0,,4228.0,,13783,13783,9750,9737,4033,4046,3512308
3318,63495,19855,19855,15772,15930,4083,3925,19482.0,,15099.0,,4383.0,,18699,18699,14771,14671,3928,4028,3512407
3319,63517,4183,4183,3339,3387,844,796,4197.0,,3405.0,,792.0,,4154,4154,3247,3255,907,899,3512506
3320,63533,3839,3839,3149,3114,690,725,3837.0,,3356.0,,481.0,,3678,3678,3153,3109,525,569,3512605
3321,63550,3519,3519,2761,2764,758,755,3430.0,,2782.0,,648.0,,3200,3200,2526,2515,674,685,3512704
3322,63576,46496,46496,35908,36168,10588,10328,45823.0,,33323.0,,12500.0,,45892,45892,34612,34632,11280,11260,3512803
3323,63592,7136,7136,5592,5715,1544,1421,6886.0,,5643.0,,1243.0,,6384,6384,4998,4950,1386,1434,3512902
3324,63614,185031,185031,149420,149244,35611,35787,174356.0,,135503.0,,38853.0,,168031,168031,135160,134190,32871,33841,3513009
3325,63630,27346,27346,20707,20970,6639,6376,26358.0,,18873.0,,7485.0,,26203,26203,19605,19627,6598,6576,3513108
3326,63657,7464,7464,5785,5893,1679,1571,7325.0,,5739.0,,1586.0,,7243,7243,5599,5565,1644,1678,3513207
3327,63673,2013,2013,1660,1655,353,358,2008.0,,1787.0,,221.0,,2116,2116,1702,1695,414,421,3513306
3328,63690,60339,60339,46562,46878,13777,13461,59843.0,,43533.0,,16310.0,,59614,59614,46290,45596,13324,14018,3513405
3329,63711,94385,94385,74508,73987,19877,20398,93658.0,,71365.0,,22293.0,,96250,96250,73486,73431,22764,22819,3513504
3330,63738,17456,17456,14086,14517,3370,2939,16842.0,,14116.0,,2726.0,,16023,16023,13297,13401,2726,2622,3513603
3331,63754,25244,25244,19447,19705,5797,5539,24626.0,,18184.0,,6442.0,,23849,23849,19570,19438,4279,4411,3513702
3332,63770,339313,339313,272250,273287,67063,66026,329171.0,329171.0,243764.0,233234.0,85407.0,95937.0,332936,332936,265576,264675,67360,68261,3513801
3333,63797,9511,9511,7741,7852,1770,1659,9453.0,,7810.0,,1643.0,,9291,9291,7794,7848,1497,1443,3513900
3334,63819,6540,6540,5175,5257,1365,1283,6396.0,,5267.0,,1129.0,,6128,6128,4832,4829,1296,1299,3514007
3335,63835,19995,19995,14484,14698,5511,5297,19774.0,,13716.0,,6058.0,,19362,19362,14225,14212,5137,5150,3514106
3336,63851,2185,2185,1742,1752,443,433,2240.0,,1942.0,,298.0,,2267,2267,1696,1688,571,579,3514205
3337,63878,7322,7322,5570,5628,1752,1694,7374.0,,5721.0,,1653.0,,7380,7380,5501,5503,1879,1877,3514304
3338,63894,35437,35437,26687,27188,8750,8249,35206.0,,25147.0,,10059.0,,35220,35220,26574,26453,8646,8767,3514403
3339,63916,10525,10525,7924,8062,2601,2463,10453.0,,7738.0,,2715.0,,10322,10322,7766,7696,2556,2626,3514502
3340,63932,7154,7154,5760,5846,1394,1308,6984.0,,5661.0,,1323.0,,6851,6851,5416,5417,1435,1434,3514601
3341,63959,5294,5294,4027,4073,1267,1221,5290.0,,4013.0,,1277.0,,5286,5286,3942,3918,1344,1368,3514700
3342,63975,11823,11823,8260,8468,3563,3355,11635.0,,8035.0,,3600.0,,11910,11910,8013,8030,3897,3880,3514809
3343,63991,14098,14098,11107,11274,2991,2824,14004.0,,11016.0,,2988.0,,13261,13261,10126,10097,3135,3164,3514908
3344,64017,199656,199656,164723,164041,34933,35615,189289.0,,149421.0,,39868.0,,181821,181821,151321,150612,30500,31209,3515004
3345,64033,56441,56441,42103,42430,14338,14011,56079.0,,40814.0,,15265.0,,52984,52984,39954,39856,13030,13128,3515103
3346,64050,7322,7322,5559,5664,1763,1658,7234.0,,5749.0,,1485.0,,7101,7101,5386,5363,1715,1738,3515202
3347,64076,2566,2566,2012,2007,554,559,2549.0,,2252.0,,297.0,,2600,2600,1911,1867,689,733,3515301
3348,64092,13272,13272,10003,10188,3269,3084,13359.0,,10091.0,,3268.0,,13201,13201,9832,9733,3369,3468,3515400
3349,64114,54395,54395,40117,41131,14278,13264,53849.0,,36279.0,,17570.0,,52410,52410,38212,38284,14198,14126,3515509
3350,64130,5091,5091,3975,3952,1116,1139,5027.0,,4350.0,,677.0,,4924,4924,3695,3615,1229,1309,3515608
3351,64157,133806,133806,106916,106654,26890,27152,130570.0,,99658.0,,30912.0,,126928,126928,100210,99421,26718,27507,3515707
3352,64173,1589,1589,1152,1167,437,422,1619.0,,1375.0,,244.0,,1733,1733,1217,1195,516,538,3515806
3353,64190,2665,2665,2146,2156,519,509,2573.0,,2170.0,,403.0,,2440,2440,2001,1973,439,467,3515905
3354,64211,8076,8076,6172,6265,1904,1811,8087.0,,6267.0,,1820.0,,8193,8193,6288,6227,1905,1966,3516002
3355,64238,2709,2709,2133,2104,576,605,2784.0,,2380.0,,404.0,,2734,2734,2074,2018,660,716,3516101
3356,64254,247161,247161,194304,197460,52857,49701,238124.0,238124.0,168300.0,159702.0,69824.0,78422.0,238375,238375,189792,188005,48583,50370,3516200
3357,64270,131201,131201,101580,102432,29621,28769,126392.0,,95396.0,,30996.0,,121391,121391,95004,94327,26387,27064,3516309
3358,64297,104865,104865,82483,82773,22382,22092,99741.0,,74882.0,,24859.0,,99272,99272,78032,77647,21240,21625,3516408
3359,64319,2546,2546,2091,2123,455,423,2478.0,,2153.0,,325.0,,2439,2439,2082,2077,357,362,3516507
3360,64335,5261,5261,3916,3932,1345,1329,5319.0,,4007.0,,1312.0,,5488,5488,4008,3953,1480,1535,3516606
3361,64351,35572,35572,26565,26869,9007,8703,35530.0,,25296.0,,10234.0,,35270,35270,26311,26020,8959,9250,3516705
3362,64378,2866,2866,2328,2333,538,533,2835.0,,2517.0,,318.0,,2731,2731,2231,2246,500,485,3516804
3363,64394,8392,8392,6444,6567,1948,1825,8304.0,,6355.0,,1949.0,,7930,7930,6431,6400,1499,1530,3516903
3364,64416,8070,8070,5534,5651,2536,2419,8120.0,,5862.0,,2258.0,,8314,8314,5602,5548,2712,2766,3517000
3365,64432,3873,3873,2988,3034,885,839,3931.0,,3255.0,,676.0,,4060,4060,3051,2996,1009,1064,3517109
3366,64459,8704,8704,6431,6507,2273,2197,8668.0,,6418.0,,2250.0,,8675,8675,6322,6319,2353,2356,3517208
3367,64475,4731,4731,3576,3590,1155,1141,4755.0,,3810.0,,945.0,,4662,4662,3457,3437,1205,1225,3517307
3368,64491,30954,30954,21201,21980,9753,8974,30530.0,,20893.0,,9637.0,,30109,30109,20598,20762,9511,9347,3517406
3369,64513,15543,15543,12133,12421,3410,3122,14890.0,,11738.0,,3152.0,,14488,14488,11212,11299,3276,3189,3517505
3370,64530,15072,15072,10954,11153,4118,3919,15004.0,,11472.0,,3532.0,,15220,15220,10942,10888,4278,4332,3517604
3371,64556,14119,14119,11514,11582,2605,2537,13777.0,,11227.0,,2550.0,,13118,13118,10936,10985,2182,2133,3517703
3372,64572,6655,6655,5059,5116,1596,1539,6765.0,,5223.0,,1542.0,,6801,6801,5042,4998,1759,1803,3517802
3373,64599,8566,8566,6450,6492,2116,2074,8433.0,,6608.0,,1825.0,,8419,8419,5963,5996,2456,2423,3517901
3374,64610,1633,1633,1348,1357,285,276,1573.0,,1413.0,,160.0,,1379,1379,1165,1167,214,212,3518008
3375,64637,5181,5181,3902,3953,1279,1228,5195.0,,4155.0,,1040.0,,5329,5329,3825,3824,1504,1505,3518107
3376,64653,23442,23442,18790,19081,4652,4361,22632.0,,17184.0,,5448.0,,21277,21277,17769,17862,3508,3415,3518206
3377,64670,25664,25664,20217,20289,5447,5375,24594.0,,18654.0,,5940.0,,24082,24082,19166,18986,4916,5096,3518305
3378,64696,95619,95619,75260,76129,20359,19490,94174.0,,68674.0,,25500.0,,92488,92488,72936,72157,19552,20331,3518404
3379,64718,9536,9536,7557,7647,1979,1889,9448.0,,7530.0,,1918.0,,8875,8875,6947,6986,1928,1889,3518503
3380,64734,29565,29565,22927,23119,6638,6446,29008.0,,21915.0,,7093.0,,28771,28771,21711,21690,7060,7081,3518602
3381,64750,235394,235394,187687,186247,47707,49147,224819.0,,170870.0,,53949.0,,226660,226660,176461,177201,50199,49459,3518701
3382,64777,928404,928404,779867,781283,148537,147121,872880.0,872880.0,700764.0,665032.0,172116.0,207848.0,814342,814342,715607,711050,98735,103292,3518800
3383,64793,3548,3548,2774,2823,774,725,3506.0,,2932.0,,574.0,,3350,3350,2694,2724,656,626,3518909
3384,64815,7228,7228,5512,5593,1716,1635,7209.0,,5665.0,,1544.0,,7113,7113,5235,5188,1878,1925,3519006
3385,64831,8605,8605,6744,6806,1861,1799,8609.0,,6944.0,,1665.0,,7994,7994,6249,6180,1745,1814,3519105
3386,64858,5140,5140,3954,3962,1186,1178,5179.0,,4107.0,,1072.0,,5235,5235,3891,3884,1344,1351,3519204
3387,64874,26294,26294,20262,20374,6032,5920,25495.0,,18742.0,,6753.0,,25007,25007,19212,19205,5795,5802,3519303
3388,64890,9349,9349,7245,7402,2104,1947,9254.0,,7353.0,,1901.0,,8821,8821,6814,6811,2007,2010,3519402
3389,64912,5245,5245,4109,4165,1136,1080,5120.0,,4161.0,,959.0,,4990,4990,3946,3943,1044,1047,3519501
3390,64939,44240,44240,33768,34344,10472,9896,43979.0,,31724.0,,12255.0,,43165,43165,33030,32867,10135,10298,3519600
3391,64955,63478,63478,47892,48731,15586,14747,62394.0,,46112.0,,16282.0,,59192,59192,44708,44584,14484,14608,3519709
3392,64971,6338,6338,4855,4905,1483,1433,6327.0,,5192.0,,1135.0,,6386,6386,4639,4561,1747,1825,3519808
3393,64998,6351,6351,4972,5058,1379,1293,6353.0,,5130.0,,1223.0,,6382,6382,4958,4971,1424,1411,3519907
3394,65013,18770,18770,14792,14758,3978,4012,18712.0,,14778.0,,3934.0,,18723,18723,14567,14560,4156,4163,3520004
3395,65030,21458,21458,15320,15561,6138,5897,21474.0,,14601.0,,6873.0,,21640,21640,14712,14763,6928,6877,3520103
3396,65056,9111,9111,7015,7072,2096,2039,8874.0,,7070.0,,1804.0,,8225,8225,6356,6331,1869,1894,3520202
3397,65072,23763,23763,16797,16941,6966,6822,23347.0,,16243.0,,7104.0,,23147,23147,15612,15557,7535,7590,3520301
3398,65099,29483,29483,22623,22831,6860,6652,27757.0,,21469.0,,6288.0,,24361,24361,17941,18022,6420,6339,3520400
3399,65110,188286,188286,150215,151644,38071,36642,177168.0,,129142.0,,48026.0,,161607,161607,130603,129823,31004,31784,3520509
3400,65137,3948,3948,3313,3368,635,580,3861.0,,3328.0,,533.0,,3720,3720,3227,3199,493,521,3520608
3401,65153,3002,3002,2487,2506,515,496,2871.0,,2515.0,,356.0,,2681,2681,2327,2301,354,380,3520707
3402,65170,3039,3039,2511,2549,528,490,2973.0,,2577.0,,396.0,,2886,2886,2474,2482,412,404,3520806
3403,65196,10758,10758,8336,8383,2422,2375,10709.0,,8465.0,,2244.0,,10747,10747,8398,8350,2349,2397,3520905
3404,65218,21424,21424,16558,16625,4866,4799,20520.0,,15402.0,,5118.0,,19866,19866,15402,15369,4464,4497,3521002
3405,65234,5651,5651,4394,4441,1257,1210,5399.0,,4152.0,,1247.0,,5247,5247,4092,4092,1155,1155,3521101
3406,65250,3480,3480,2469,2516,1011,964,3428.0,,2636.0,,792.0,,3498,3498,2338,2312,1160,1186,3521200
3407,65277,11500,11500,9078,9267,2422,2233,11388.0,,9423.0,,1965.0,,10779,10779,8355,8325,2424,2454,3521309
3408,65293,18058,18058,14864,14929,3194,3129,17717.0,,14172.0,,3545.0,,17436,17436,14378,14239,3058,3197,3521408
3409,65315,5698,5698,4189,4383,1509,1315,5730.0,,4501.0,,1229.0,,5727,5727,4247,4271,1480,1456,3521507
3410,65331,5041,5041,3744,3798,1297,1243,5104.0,,3950.0,,1154.0,,5280,5280,3922,3883,1358,1397,3521606
3411,65358,14329,14329,11152,11337,3177,2992,14108.0,,11013.0,,3095.0,,14153,14153,11263,11129,2890,3024,3521705
3412,65374,17555,17555,13396,13787,4159,3768,17350.0,,13543.0,,3807.0,,16997,16997,12950,13003,4047,3994,3521804
3413,65390,12716,12716,9887,10141,2829,2575,12578.0,,9974.0,,2604.0,,12212,12212,9405,9532,2807,2680,3521903
3414,65412,3182,3182,2372,2404,810,778,3150.0,,2528.0,,622.0,,3106,3106,2261,2272,845,834,3522000
3415,65439,85042,85042,61260,61233,23782,23809,81271.0,,54920.0,,26351.0,,75815,75815,51901,52422,23914,23393,3522109
3416,65455,123695,123695,97857,98075,25838,25620,119107.0,,90024.0,,29083.0,,115883,115883,91173,90748,24710,25135,3522208
3417,65471,117697,117697,91168,92230,26529,25467,114782.0,,83667.0,,31115.0,,109056,109056,84273,84109,24783,24947,3522307
3418,65498,72160,72160,54790,55470,17370,16690,71587.0,,51342.0,,20245.0,,69461,69461,53103,52364,16358,17097,3522406
3419,65510,163889,163889,130436,129820,33453,34069,153444.0,,117574.0,,35870.0,,149974,149974,118567,117968,31407,32006,3522505
3420,65536,57492,57492,44400,45151,13092,12341,56941.0,,41281.0,,15660.0,,55972,55972,43630,43373,12342,12599,3522604
3421,65552,31419,31419,23219,23840,8200,7579,31422.0,,21916.0,,9506.0,,30978,30978,22248,22292,8730,8686,3522703
3422,65579,11656,11656,8544,8835,3112,2821,11476.0,,8592.0,,2884.0,,11591,11591,8502,8554,3089,3037,3522802
3423,65595,10193,10193,7877,7912,2316,2281,9922.0,,7887.0,,2035.0,,9243,9243,7226,7106,2017,2137,3522901
3424,65617,3782,3782,2631,2624,1151,1158,3847.0,,2987.0,,860.0,,3859,3859,2701,2666,1158,1193,3523008
3425,65633,251377,251377,199410,199657,51967,51720,239226.0,,182221.0,,57005.0,,232295,232295,185621,183877,46674,48418,3523107
3426,65650,36541,36541,26483,26924,10058,9617,36274.0,,24521.0,,11753.0,,36636,36636,26267,26112,10369,10524,3523206
3427,65676,9780,9780,6983,6980,2797,2800,9751.0,,7153.0,,2598.0,,9611,9611,6412,6458,3199,3153,3523305
3428,65692,85747,85747,68099,68621,17648,17126,82243.0,,61160.0,,21083.0,,79783,79783,62930,62858,16853,16925,3523404
3429,65714,13884,13884,10982,11101,2902,2783,13597.0,,10822.0,,2775.0,,13085,13085,10928,10832,2157,2253,3523503
3430,65730,10161,10161,7906,7972,2255,2189,9985.0,,7844.0,,2141.0,,9531,9531,7589,7489,1942,2042,3523602
3431,65757,5098,5098,3840,3923,1258,1175,5028.0,,3954.0,,1074.0,,5033,5033,3716,3735,1317,1298,3523701
3432,65773,6313,6313,4939,4900,1374,1413,6265.0,,5034.0,,1231.0,,6348,6348,4867,4856,1481,1492,3523800
3433,65790,126674,126674,98766,99158,27908,27516,121190.0,,87502.0,,33688.0,,122652,122652,95165,94286,27487,28366,3523909
3434,65811,45168,45168,35861,36029,9307,9139,41560.0,,30855.0,,10705.0,,40440,40440,32023,32094,8417,8346,3524006
3435,65838,30041,30041,21806,22253,8235,7788,30230.0,,20530.0,,9700.0,,29953,29953,21152,20861,8801,9092,3524105
3436,65854,5228,5228,4205,4260,1023,968,5135.0,,4416.0,,719.0,,5095,5095,3921,3927,1174,1168,3524204
3437,65870,55170,55170,40788,41533,14382,13637,54664.0,,37104.0,,17560.0,,53550,53550,38812,38675,14738,14875,3524303
3438,65897,176834,176834,138893,140326,37941,36508,171850.0,,124363.0,,47487.0,,164797,164797,130327,129483,34470,35314,3524402
3439,65919,5770,5770,4499,4614,1271,1156,5678.0,,4704.0,,974.0,,5486,5486,4222,4171,1264,1315,3524501
3440,65935,13604,13604,9622,9703,3982,3901,13554.0,,9258.0,,4296.0,,13527,13527,9365,9302,4162,4225,3524600
3441,65951,44995,44995,35248,35351,9747,9644,42996.0,,32259.0,,10737.0,,39517,39517,30801,30822,8716,8695,3524709
3442,65978,38572,38572,29563,30097,9009,8475,38520.0,,26301.0,,12219.0,,38021,38021,28839,28564,9182,9457,3524808
3443,65994,4970,4970,3960,3961,1010,1009,4859.0,,3853.0,,1006.0,,4898,4898,3878,3828,1020,1070,3524907
3444,66010,81159,81159,64508,64819,16651,16340,79853.0,,60217.0,,19636.0,,78720,78720,62603,62208,16117,16512,3525003
3445,66036,30546,30546,22481,22996,8065,7550,29772.0,,20674.0,,9098.0,,28321,28321,20525,20713,7796,7608,3525102
3446,66052,26423,26423,19900,20165,6523,6258,24910.0,,18795.0,,6115.0,,22651,22651,17209,17203,5442,5448,3525201
3447,66079,104871,104871,82259,83137,22612,21734,103540.0,,75838.0,,27702.0,,100984,100984,79466,78805,21518,22179,3525300
3448,66095,3043,3043,2489,2497,554,546,2965.0,,2691.0,,274.0,,2739,2739,2307,2248,432,491,3525409
3449,66117,9969,9969,7776,7887,2193,2082,9928.0,,7722.0,,2206.0,,9459,9459,7277,7283,2182,2176,3525508
3450,66133,3432,3432,2727,2739,705,693,3319.0,,2833.0,,486.0,,3144,3144,2653,2618,491,526,3525607
3451,66150,28393,28393,21671,22203,6722,6190,28282.0,,20443.0,,7839.0,,26575,26575,19800,20113,6775,6462,3525706
3452,66176,3791,3791,3014,2989,777,802,3732.0,,3180.0,,552.0,,3814,3814,2968,2891,846,923,3525805
3453,66192,330952,330952,267001,267896,63951,63056,314875.0,,228515.0,,86360.0,,308201,308201,251956,251666,56245,56535,3525904
3454,66214,13922,13922,10845,11036,3077,2886,13671.0,,10341.0,,3330.0,,13220,13220,11098,10983,2122,2237,3526001
3455,66230,17131,17131,11402,11392,5729,5739,17075.0,,11589.0,,5486.0,,16790,16790,10957,10674,5833,6116,3526100
3456,66257,23942,23942,18194,18202,5748,5740,23719.0,,18420.0,,5299.0,,22852,22852,17108,16941,5744,5911,3526209
3457,66273,5309,5309,4228,4221,1081,1088,5175.0,,4241.0,,934.0,,5041,5041,4124,4023,917,1018,3526308
3458,66290,22105,22105,16661,16796,5444,5309,21913.0,,15926.0,,5987.0,,21164,21164,16171,16152,4993,5012,3526407
3459,66311,3966,3966,3070,3105,896,861,3977.0,,3212.0,,765.0,,4187,4187,3077,3088,1110,1099,3526506
3460,66338,6282,6282,5060,5064,1222,1218,6172.0,,5039.0,,1133.0,,6204,6204,4911,4800,1293,1404,3526605
3461,66354,75761,75761,58870,59874,16891,15887,74682.0,,56071.0,,18611.0,,73298,73298,57402,57037,15896,16261,3526704
3462,66370,51429,51429,40822,41257,10607,10172,50506.0,,38625.0,,11881.0,,49067,49067,39645,39201,9422,9866,3526803
3463,66397,230262,230262,182455,185413,47807,44849,226627.0,226627.0,163294.0,156895.0,63333.0,69732.0,216609,216609,172486,171644,44123,44965,3526902
3464,66419,5927,5927,4687,4708,1240,1219,5831.0,,4745.0,,1086.0,,5683,5683,4445,4457,1238,1226,3527009
3465,66435,58154,58154,43141,43662,15013,14492,58106.0,,40552.0,,17554.0,,56995,56995,42508,42210,14487,14785,3527108
3466,66451,65120,65120,50446,51165,14674,13955,64197.0,,47932.0,,16265.0,,63654,63654,49225,48523,14429,15131,3527207
3467,66478,37312,37312,30707,30971,6605,6341,34897.0,,28299.0,,6598.0,,32961,32961,27368,27413,5593,5548,3527306
3468,66494,13581,13581,10464,10652,3117,2929,13297.0,,10009.0,,3288.0,,12594,12594,10179,10212,2415,2382,3527405
3469,66516,2130,2130,1697,1668,433,462,2102.0,,1787.0,,315.0,,2074,2074,1600,1580,474,494,3527504
3470,66532,10217,10217,7710,7725,2507,2492,9965.0,,7890.0,,2075.0,,9583,9583,6964,6915,2619,2668,3527603
3471,66559,3934,3934,3046,3116,888,818,3977.0,,3287.0,,690.0,,4006,4006,2977,2966,1029,1040,3527702
3472,66575,3472,3472,2678,2699,794,773,3466.0,,2850.0,,616.0,,3594,3594,2631,2608,963,986,3527801
3473,66591,2450,2450,1922,1944,528,506,2484.0,,2113.0,,371.0,,2543,2543,1895,1886,648,657,3527900
3474,66613,13281,13281,10594,10573,2687,2708,13162.0,,10641.0,,2521.0,,13093,13093,10384,10245,2709,2848,3528007
3475,66630,6162,6162,4891,4980,1271,1182,6110.0,,4987.0,,1123.0,,5982,5982,4650,4665,1332,1317,3528106
3476,66656,3608,3608,2847,2895,761,713,3452.0,,3040.0,,412.0,,2819,2819,2338,2324,481,495,3528205
3477,66672,2667,2667,2190,2246,477,421,2656.0,,2389.0,,267.0,,2557,2557,2171,2142,386,415,3528304
3478,66699,40243,40243,31265,31427,8978,8816,39215.0,,29148.0,,10067.0,,37407,37407,29089,28801,8318,8606,3528403
3479,66710,65866,65866,51641,51906,14225,13960,63775.0,,47296.0,,16479.0,,61289,61289,47648,47274,13641,14015,3528502
3480,66737,7467,7467,5778,5809,1689,1658,7420.0,,5719.0,,1701.0,,7299,7299,5715,5633,1584,1666,3528601
3481,66753,3104,3104,2329,2332,775,772,3186.0,,2568.0,,618.0,,3303,3303,2353,2262,950,1041,3528700
3482,66770,10925,10925,8625,8686,2300,2239,10872.0,,8797.0,,2075.0,,10845,10845,8383,8375,2462,2470,3528809
3483,66796,3060,3060,2406,2423,654,637,3030.0,,2472.0,,558.0,,3169,3169,2408,2390,761,779,3528908
3484,66818,181389,181389,139167,140990,42222,40399,178917.0,,125732.0,,53185.0,,171775,171775,131905,131048,39870,40727,3529005
3485,66834,1806,1806,1434,1443,372,363,1818.0,,1549.0,,269.0,,1866,1866,1443,1456,423,410,3529104
3486,66850,17960,17960,14441,14682,3519,3278,17513.0,,13991.0,,3522.0,,16749,16749,13991,13949,2758,2800,3529203
3487,66877,66317,66317,52337,53145,13980,13172,65683.0,,48953.0,,16730.0,,63989,63989,49802,49718,14187,14271,3529302
3488,66893,315710,315710,253973,254831,61737,60879,306518.0,306518.0,234498.0,219897.0,72020.0,86621.0,306653,306653,245950,245054,60703,61599,3529401
3489,66915,5045,5045,3906,4005,1139,1040,4730.0,,3953.0,,777.0,,4478,4478,3437,3443,1041,1035,3529500
3490,66931,3649,3649,2971,3002,678,647,3510.0,,3118.0,,392.0,,3135,3135,2651,2625,484,510,3529609
3491,66958,14772,14772,11698,11933,3074,2839,14313.0,,11732.0,,2581.0,,13770,13770,10882,10886,2888,2884,3529708
3492,66974,9361,9361,7207,7220,2154,2141,9305.0,,7130.0,,2175.0,,9224,9224,7108,7084,2116,2140,3529807
3493,66990,16746,16746,11475,11580,5271,5166,16809.0,,11349.0,,5460.0,,17300,17300,11152,11228,6148,6072,3529906
3494,67016,2749,2749,2073,2077,676,672,2761.0,,2307.0,,454.0,,2592,2592,1944,1900,648,692,3530003
3495,67032,20051,20051,14380,14652,5671,5399,20080.0,,13601.0,,6479.0,,20213,20213,14226,14243,5987,5970,3530102
3496,67059,13268,13268,9955,10125,3313,3143,13145.0,,10196.0,,2949.0,,12431,12431,9560,9565,2871,2866,3530201
3497,67075,45180,45180,35116,35835,10064,9345,44262.0,,31667.0,,12595.0,,42498,42498,32350,32628,10148,9870,3530300
3498,67091,4088,4088,3241,3288,847,800,3922.0,,3299.0,,623.0,,3565,3565,2776,2785,789,780,3530409
3499,67113,53431,53431,38823,39690,14608,13741,52878.0,,35154.0,,17724.0,,53411,53411,38247,38301,15164,15110,3530508
3500,67130,332982,332982,263192,262539,69790,70443,319826.0,319826.0,230971.0,220456.0,88855.0,99370.0,309844,309844,246130,244169,63714,65675,3530607
3501,67156,119695,119695,93721,94752,25974,24943,117152.0,,83730.0,,33422.0,,113319,113319,88871,88663,24448,24656,3530706
3502,67172,71328,71328,55504,56147,15824,15181,70434.0,,49592.0,,20842.0,,68088,68088,52522,52609,15566,15479,3530805
3503,67199,3248,3248,2566,2569,682,679,3240.0,,2741.0,,499.0,,3296,3296,2567,2561,729,735,3530904
3504,67210,2046,2046,1616,1648,430,398,2025.0,,1795.0,,230.0,,1941,1941,1596,1590,345,351,3531001
3505,67237,50019,50019,35456,35369,14563,14650,47506.0,,33611.0,,13895.0,,44495,44495,30333,30854,14162,13641,3531100
3506,67253,6591,6591,5178,5246,1413,1345,6465.0,,5026.0,,1439.0,,6170,6170,4863,4845,1307,1325,3531209
3507,67270,38289,38289,28770,29469,9519,8820,37998.0,,27159.0,,10839.0,,37137,37137,27532,27590,9605,9547,3531308
3508,67296,17862,17862,13595,13892,4267,3970,17800.0,,12991.0,,4809.0,,17181,17181,12895,13005,4286,4176,3531407
3509,67318,14233,14233,11436,11529,2797,2704,13785.0,,11182.0,,2603.0,,13375,13375,11199,11198,2176,2177,3531506
3510,67334,3494,3494,2810,2839,684,655,3459.0,,2971.0,,488.0,,3438,3438,2720,2711,718,727,3531605
3511,67350,3971,3971,3081,3135,890,836,3869.0,,3043.0,,826.0,,3720,3720,2862,2849,858,871,3531704
3512,67377,47499,47499,36370,36758,11129,10741,45959.0,,33536.0,,12423.0,,41406,41406,31510,31302,9896,10104,3531803
3513,67393,21198,21198,16210,16405,4988,4793,20833.0,,15477.0,,5356.0,,20749,20749,15461,15382,5288,5367,3531902
3514,67415,10759,10759,8634,8735,2125,2024,10673.0,,8499.0,,2174.0,,10163,10163,8342,8278,1821,1885,3532009
3515,67431,3505,3505,2742,2779,763,726,3506.0,,2896.0,,610.0,,3592,3592,2681,2631,911,961,3532108
3516,67458,4464,4464,3552,3602,912,862,4329.0,,3673.0,,656.0,,4225,4225,3245,3237,980,988,3532207
3517,67474,6008,6008,4352,4372,1656,1636,6016.0,,4618.0,,1398.0,,6380,6380,4375,4307,2005,2073,3532306
3518,67490,15059,15059,11481,11506,3578,3553,14889.0,,11538.0,,3351.0,,14073,14073,10519,10383,3554,3690,3532405
3519,67512,7696,7696,5950,6074,1746,1622,7664.0,,6083.0,,1581.0,,7580,7580,5746,5772,1834,1808,3532504
3520,67539,7776,7776,6172,6240,1604,1536,7590.0,,6005.0,,1585.0,,7260,7260,6093,6095,1167,1165,3532603
3521,67555,3951,3951,2977,3031,974,920,3974.0,,3224.0,,750.0,,3897,3897,2809,2815,1088,1082,3532702
3522,67571,5218,5218,4150,4189,1068,1029,5074.0,,4134.0,,940.0,,5100,5100,3952,3951,1148,1149,3532801
3523,67598,7786,7786,6009,6077,1777,1709,7745.0,,6071.0,,1674.0,,7709,7709,5732,5734,1977,1975,3532900
3524,67610,15937,15937,12000,12186,3937,3751,15813.0,,11661.0,,4152.0,,15569,15569,11049,11091,4520,4478,3533007
3525,67636,1988,1988,1506,1584,482,404,2005.0,,1757.0,,248.0,,1998,1998,1535,1540,463,458,3533106
3526,67652,3231,3231,2596,2622,635,609,3146.0,,2784.0,,362.0,,2759,2759,2358,2333,401,426,3533205
3527,67679,2674,2674,2183,2168,491,506,2679.0,,2365.0,,314.0,,2549,2549,2159,2198,390,351,3533304
3528,67695,47897,47897,38318,38720,9579,9177,46731.0,,35136.0,,11595.0,,45570,45570,36810,36540,8760,9030,3533403
3529,67717,30294,30294,22658,22835,7636,7459,30038.0,,21247.0,,8791.0,,29338,29338,21983,21900,7355,7438,3533502
3530,67733,5954,5954,4682,4757,1272,1197,5850.0,,4878.0,,972.0,,5822,5822,4423,4466,1399,1356,3533601
3531,67750,3289,3289,2683,2722,606,567,3215.0,,2746.0,,469.0,,3068,3068,2648,2619,420,449,3533700
3532,67776,2547,2547,1932,1956,615,591,2566.0,,2111.0,,455.0,,2669,2669,2041,1996,628,673,3533809
3533,67792,43594,43594,32851,33277,10743,10317,42922.0,,30466.0,,12456.0,,41115,41115,30133,30099,10982,11016,3533908
3534,67814,4148,4148,3282,3306,866,842,4033.0,,3355.0,,678.0,,3832,3832,2901,2832,931,1000,3534005
3535,67830,5019,5019,4158,4190,861,829,4930.0,,4237.0,,693.0,,4600,4600,4007,4027,593,573,3534104
3536,67857,5008,5008,3938,3995,1070,1013,5015.0,,4350.0,,665.0,,4703,4703,3604,3578,1099,1125,3534203
3537,67873,31757,31757,24061,24548,7696,7209,31399.0,,21980.0,,9419.0,,30871,30871,23334,23209,7537,7662,3534302
3538,67890,588106,588106,466340,468683,121766,119423,567361.0,,407183.0,,160178.0,,569477,569477,450364,449232,119113,120245,3534401
3539,67911,2520,2520,1937,1929,583,591,2543.0,,2173.0,,370.0,,2747,2747,2027,1993,720,754,3534500
3540,67938,24768,24768,18205,18696,6563,6072,24655.0,,17179.0,,7476.0,,24641,24641,18065,17957,6576,6684,3534609
3541,67954,81097,81097,61530,62157,19567,18940,80304.0,,58578.0,,21726.0,,79030,79030,60141,59308,18889,19722,3534708
3542,67970,6146,6146,4716,4810,1430,1336,6139.0,,4900.0,,1239.0,,6227,6227,4725,4764,1502,1463,3534807
3543,67997,8643,8643,6229,6386,2414,2257,8823.0,,6385.0,,2438.0,,9013,9013,6388,6353,2625,2660,3534906
3544,68012,9211,9211,6955,7087,2256,2124,9238.0,,7334.0,,1904.0,,9230,9230,6828,6836,2402,2394,3535002
3545,68039,7852,7852,6348,6420,1504,1432,7855.0,,6415.0,,1440.0,,7421,7421,5991,5997,1430,1424,3535101
3546,68055,7956,7956,5791,6019,2165,1937,7941.0,,5753.0,,2188.0,,8022,8022,5745,5794,2277,2228,3535200
3547,68071,17310,17310,13072,13320,4238,3990,17236.0,,13099.0,,4137.0,,17277,17277,12842,12846,4435,4431,3535309
3548,68098,10791,10791,8327,8333,2464,2458,10777.0,,8292.0,,2485.0,,10531,10531,7818,7815,2713,2716,3535408
3549,68110,32600,32600,24144,24598,8456,8002,32387.0,,23170.0,,9217.0,,32544,32544,23761,23709,8783,8835,3535507
3550,68136,14283,14283,10865,11102,3418,3181,14001.0,,10265.0,,3736.0,,14448,14448,10645,10663,3803,3785,3535606
3551,68152,4504,4504,3779,3806,725,698,4400.0,,3884.0,,516.0,,4350,4350,3860,3885,490,465,3535705
3552,68179,14286,14286,10981,11177,3305,3109,14248.0,,11088.0,,3160.0,,13879,13879,10646,10616,3233,3263,3535804
3553,68195,3428,3428,2834,2885,594,543,3371.0,,2979.0,,392.0,,3144,3144,2547,2505,597,639,3535903
3554,68217,8284,8284,6245,6305,2039,1979,8349.0,,6257.0,,2092.0,,8523,8523,6313,6306,2210,2217,3536000
3555,68233,5736,5736,4447,4451,1289,1285,5491.0,,4527.0,,964.0,,5139,5139,4193,4178,946,961,3536109
3556,68250,15626,15626,11571,11631,4055,3995,15426.0,,11174.0,,4252.0,,15034,15034,10973,10984,4061,4050,3536208
3557,68276,10855,10855,8214,8409,2641,2446,10672.0,,8000.0,,2672.0,,10783,10783,8244,8168,2539,2615,3536307
3558,68292,5958,5958,4546,4615,1412,1343,5894.0,,4804.0,,1090.0,,5929,5929,4307,4288,1622,1641,3536406
3559,68314,84252,84252,67422,67997,16830,16255,79885.0,,61494.0,,18391.0,,73171,73171,58197,58182,14974,14989,3536505
3560,68330,6450,6450,4769,4839,1681,1611,6465.0,,5145.0,,1320.0,,6543,6543,4647,4600,1896,1943,3536604
3561,68357,34629,34629,26953,27322,7676,7307,34102.0,,25810.0,,8292.0,,33014,33014,25568,25415,7446,7599,3536703
3562,68373,5212,5212,3998,4091,1214,1121,5154.0,,3952.0,,1202.0,,5081,5081,3845,3853,1236,1228,3536802
3563,68390,2337,2337,1921,1955,416,382,2300.0,,2121.0,,179.0,,1877,1877,1626,1617,251,260,3536901
3564,68411,11874,11874,9605,9515,2269,2359,11455.0,,9560.0,,1895.0,,10856,10856,9103,8973,1753,1883,3537008
3565,68438,35328,35328,27311,27589,8017,7739,34887.0,,25153.0,,9734.0,,34369,34369,26449,26463,7920,7906,3537107
3566,68454,8451,8451,5717,5685,2734,2766,8420.0,,6006.0,,2414.0,,8238,8238,5252,5248,2986,2990,3537206
3567,68470,47524,47524,35465,36218,12059,11306,47097.0,,32165.0,,14932.0,,46129,46129,33895,33710,12234,12419,3537305
3568,68497,20513,20513,14662,14889,5851,5624,20422.0,,14022.0,,6400.0,,20501,20501,14385,14285,6116,6216,3537404
3569,68519,6840,6840,5072,5058,1768,1782,6699.0,,5026.0,,1673.0,,6748,6748,4909,4881,1839,1867,3537503
3570,68535,61798,61798,43631,43979,18167,17819,59352.0,,40427.0,,18925.0,,55852,55852,37819,38275,18033,17577,3537602
3571,68551,4682,4682,3680,3751,1002,931,4593.0,,3691.0,,902.0,,4609,4609,3787,3801,822,808,3537701
3572,68578,43483,43483,32313,32894,11170,10589,42730.0,,29030.0,,13700.0,,42286,42286,32177,32099,10109,10187,3537800
3573,68594,23403,23403,17862,18262,5541,5141,22494.0,,16538.0,,5956.0,,21662,21662,17048,17011,4614,4651,3537909
3574,68616,122040,122040,95322,96132,26718,25908,118620.0,,86640.0,,31980.0,,113051,113051,87864,87306,25187,25745,3538006
3575,68632,11420,11420,8713,8919,2707,2501,11473.0,,8829.0,,2644.0,,11540,11540,8817,8874,2723,2666,3538105
3576,68659,33828,33828,25011,25419,8817,8409,33790.0,,22820.0,,10970.0,,33949,33949,24733,24777,9216,9172,3515186
3577,68675,11749,11749,8827,9070,2922,2679,11659.0,,8709.0,,2950.0,,10626,10626,7994,8021,2632,2605,3538204
3578,68691,2968,2968,2389,2432,579,536,2903.0,,2666.0,,237.0,,2746,2746,2269,2274,477,472,3538303
3579,68713,10087,10087,7971,8044,2116,2043,9773.0,,7899.0,,1874.0,,9143,9143,7839,7782,1304,1361,3538501
3580,68730,22645,22645,17430,17588,5215,5057,22348.0,,16066.0,,6282.0,,22076,22076,16683,16651,5393,5425,3538600
3581,68756,307053,307053,239168,241635,67885,65418,290998.0,290998.0,202203.0,190804.0,88795.0,100194.0,288967,288967,227431,226084,61536,62883,3538709
3582,68772,24025,24025,17689,17913,6336,6112,23735.0,,16560.0,,7175.0,,23593,23593,17302,17120,6291,6473,3538808
3583,68799,16218,16218,11976,12002,4242,4216,16225.0,,11749.0,,4476.0,,16074,16074,11702,11514,4372,4560,3538907
3584,68810,8544,8544,6565,6660,1979,1884,8602.0,,6666.0,,1936.0,,8042,8042,6198,6162,1844,1880,3539004
3585,68837,13292,13292,10755,10645,2537,2647,12870.0,,10798.0,,2072.0,,12022,12022,9658,9457,2364,2565,3539103
3586,68853,21216,21216,15952,16149,5264,5067,21029.0,,15626.0,,5403.0,,20537,20537,14963,15023,5574,5514,3539202
3587,68870,59355,59355,45251,45885,14104,13470,58734.0,,41308.0,,17426.0,,57715,57715,44526,44232,13189,13483,3539301
3588,68896,9629,9629,7803,7891,1826,1738,9218.0,,7360.0,,1858.0,,8534,8534,7274,7238,1260,1296,3539400
3589,68918,26840,26840,20312,20580,6528,6260,26608.0,,19940.0,,6668.0,,26525,26525,19438,19370,7087,7155,3539509
3590,68934,4141,4141,3149,3197,992,944,4177.0,,3593.0,,584.0,,4178,4178,3182,3148,996,1030,3539608
3591,68950,2714,2714,2113,2129,601,585,2752.0,,2356.0,,396.0,,2778,2778,2100,2107,678,671,3539707
3592,68977,94984,94984,75653,75785,19331,19199,93853.0,,70736.0,,23117.0,,93626,93626,73820,73241,19806,20385,3539806
3593,68993,4545,4545,3480,3554,1065,991,4566.0,,3583.0,,983.0,,4548,4548,3387,3382,1161,1166,3539905
3594,69019,16871,16871,13186,13312,3685,3559,16691.0,,13245.0,,3446.0,,16327,16327,12815,12696,3512,3631,3540002
3595,69035,3071,3071,2392,2404,679,667,3117.0,,2629.0,,488.0,,3180,3180,2451,2399,729,781,3540101
3596,69051,29945,29945,23653,23812,6292,6133,29359.0,,22742.0,,6617.0,,27653,27653,21167,21135,6486,6518,3540200
3597,69078,2358,2358,1771,1819,587,539,2395.0,,2006.0,,389.0,,2491,2491,1907,1898,584,593,3540309
3598,69094,3780,3780,2930,2962,850,818,3759.0,,3214.0,,545.0,,3691,3691,2816,2773,875,918,3540408
3599,69116,7437,7437,5557,5719,1880,1718,7180.0,,5426.0,,1754.0,,6571,6571,4917,4872,1654,1699,3540507
3600,69132,42612,42612,32690,33169,9922,9443,41617.0,,30248.0,,11369.0,,40560,40560,31791,31700,8769,8860,3540606
3601,69159,42556,42556,32493,32880,10063,9676,42059.0,,30789.0,,11270.0,,41391,41391,32034,31928,9357,9463,3540705
3602,69175,13691,13691,10921,11137,2770,2554,12808.0,,10279.0,,2529.0,,12657,12657,9741,9839,2916,2818,3540804
3603,69191,13892,13892,11019,11055,2873,2837,13831.0,,10826.0,,3005.0,,13254,13254,10361,10319,2893,2935,3540903
3604,69213,247153,247153,187988,187995,59165,59158,226260.0,226260.0,158190.0,152330.0,68070.0,73930.0,213666,213666,159034,159218,54632,54448,3541000
3605,69230,3458,3458,2676,2691,782,767,3499.0,,2932.0,,567.0,,3574,3574,2732,2693,842,881,3541109
3606,69256,11231,11231,8189,8453,3042,2778,11260.0,,8025.0,,3235.0,,11450,11450,8055,8108,3395,3342,3541208
3607,69272,32095,32095,22811,23065,9284,9030,31844.0,,22214.0,,9630.0,,31797,31797,22316,21959,9481,9838,3541307
3608,69299,180860,180860,134753,137102,46107,43758,178309.0,,120553.0,,57756.0,,172720,172720,127529,127189,45191,45531,3541406
3609,69310,29020,29020,21436,21773,7584,7247,29040.0,,20650.0,,8390.0,,29142,29142,21567,21555,7575,7587,3541505
3610,69337,28493,28493,20575,21028,7918,7465,28223.0,,19785.0,,8438.0,,28282,28282,20231,20148,8051,8134,3541604
3611,69353,10153,10153,8023,8125,2130,2028,9914.0,,7766.0,,2148.0,,9554,9554,8120,8027,1434,1527,3541703
3612,69370,3293,3293,2431,2440,862,853,3306.0,,2936.0,,370.0,,3364,3364,2349,2217,1015,1147,3541802
3613,69396,7181,7181,5703,5698,1478,1483,6923.0,,5695.0,,1228.0,,6526,6526,5355,5327,1171,1199,3541901
3614,69418,5475,5475,4280,4329,1195,1146,5398.0,,4486.0,,912.0,,5236,5236,4069,4037,1167,1199,3542008
3615,69434,7420,7420,5990,6047,1430,1373,7338.0,,5640.0,,1698.0,,7496,7496,6074,6062,1422,1434,3542107
3616,69450,24544,24544,18162,18345,6382,6199,24417.0,,17784.0,,6633.0,,24806,24806,18403,18150,6403,6656,3542206
3617,69477,4240,4240,3145,3215,1095,1025,4246.0,,3351.0,,895.0,,4057,4057,3046,3021,1011,1036,3542305
3618,69493,15278,15278,12456,12655,2822,2623,14741.0,,11948.0,,2793.0,,13812,13812,11584,11620,2228,2192,3542404
3619,69515,4932,4932,3794,3819,1138,1113,4745.0,,3944.0,,801.0,,4547,4547,3553,3547,994,1000,3542503
3620,69531,48236,48236,35308,35283,12928,12953,47115.0,,32351.0,,14764.0,,46205,46205,33425,33129,12780,13076,3542602
3621,69558,6750,6750,5187,5241,1563,1509,6730.0,,5513.0,,1217.0,,6532,6532,4858,4845,1674,1687,3542701
3622,69574,3027,3027,2335,2341,692,686,3067.0,,2605.0,,462.0,,2996,2996,2243,2211,753,785,3542800
3623,69590,9247,9247,6697,6767,2550,2480,9055.0,,6638.0,,2417.0,,9105,9105,6602,6534,2503,2571,3542909
3624,69612,15086,15086,11342,11505,3744,3581,14914.0,,11601.0,,3313.0,,15190,15190,11395,11268,3795,3922,3543006
3625,69639,4292,4292,3271,3402,1021,890,4142.0,,3452.0,,690.0,,4028,4028,3030,3041,998,987,3543105
3626,69655,3809,3809,3183,3238,626,571,3685.0,,3257.0,,428.0,,3531,3531,3113,3077,418,454,3543204
3627,69671,90990,90990,72113,72485,18877,18505,90484.0,,68018.0,,22466.0,,90632,90632,71460,71121,19172,19511,3543303
3628,69698,467661,467661,360806,365369,106855,102292,441845.0,441845.0,298508.0,284505.0,143337.0,157340.0,443222,443222,337567,337777,105655,105445,3543402
3629,69710,4646,4646,3570,3624,1076,1022,4645.0,,3664.0,,981.0,,4712,4712,3513,3479,1199,1233,3543501
3630,69736,4519,4519,3425,3456,1094,1063,4352.0,,3655.0,,697.0,,3702,3702,2943,2813,759,889,3543600
3631,69752,7711,7711,5863,5877,1848,1834,7715.0,,5874.0,,1841.0,,7828,7828,5834,5952,1994,1876,3543709
3632,69779,7698,7698,5835,5951,1863,1747,7678.0,,5933.0,,1745.0,,7702,7702,5885,5810,1817,1892,3543808
3633,69795,156393,156393,122227,123884,34166,32509,154981.0,,111246.0,,43735.0,,148111,148111,116324,116113,31787,31998,3543907
3634,69817,25114,25114,20266,20431,4848,4683,24265.0,,18942.0,,5323.0,,24380,24380,19347,19326,5033,5054,3544004
3635,69833,35759,35759,28268,28214,7491,7545,35384.0,,27481.0,,7903.0,,34882,34882,27592,27250,7290,7632,3544103
3636,69850,7290,7290,5569,5602,1721,1688,7287.0,,5894.0,,1393.0,,7200,7200,5236,5154,1964,2046,3544202
3637,69876,8587,8587,6946,6970,1641,1617,8476.0,,7047.0,,1429.0,,8453,8453,6642,6587,1811,1866,3544301
3638,69892,2286,2286,1876,1856,410,430,2220.0,,1948.0,,272.0,,2053,2053,1763,1734,290,319,3544400
3639,69914,3278,3278,2446,2482,832,796,3202.0,,2580.0,,622.0,,3047,3047,2227,2189,820,858,3544509
3640,69930,4621,4621,3341,3413,1280,1208,4665.0,,3568.0,,1097.0,,4777,4777,3365,3363,1412,1414,3544608
3641,69957,2097,2097,1623,1637,474,460,2077.0,,1842.0,,235.0,,2088,2088,1655,1615,433,473,3544707
3642,69973,5149,5149,3937,4011,1212,1138,5145.0,,4317.0,,828.0,,5067,5067,3850,3714,1217,1353,3544806
3643,69990,8328,8328,6781,6812,1547,1516,8151.0,,6700.0,,1451.0,,8096,8096,6455,6509,1641,1587,3544905
3644,70017,15422,15422,11984,12072,3438,3350,15239.0,,11593.0,,3646.0,,15202,15202,11740,11606,3462,3596,3545001
3645,70033,4045,4045,3104,3135,941,910,4032.0,,3352.0,,680.0,,4106,4106,3141,3143,965,963,3545100
3646,70050,97134,97134,76914,77730,20220,19404,94156.0,,68923.0,,25233.0,,88726,88726,70905,70582,17821,18144,3545209
3647,70076,30721,30721,24458,24742,6263,5979,29154.0,,22620.0,,6534.0,,28104,28104,24029,24114,4075,3990,3545308
3648,70092,6385,6385,5201,5220,1184,1165,6166.0,,5229.0,,937.0,,5842,5842,4997,4994,845,848,3545407
3649,70114,3503,3503,2628,2645,875,858,3496.0,,2987.0,,509.0,,3618,3618,2591,2530,1027,1088,3545506
3650,70130,11783,11783,8819,8833,2964,2950,11813.0,,8848.0,,2965.0,,11775,11775,8398,8464,3377,3311,3545605
3651,70157,5220,5220,4085,4119,1135,1101,5140.0,,4274.0,,866.0,,4924,4924,3755,3748,1169,1176,3545704
3652,70173,146207,146207,116576,117846,29631,28361,143648.0,,107280.0,,36368.0,,140097,140097,113138,112395,26959,27702,3545803
3653,70190,5377,5377,3916,3958,1461,1419,5195.0,,3877.0,,1318.0,,5145,5145,3750,3725,1395,1420,3500550
3654,70211,12387,12387,9366,9359,3021,3028,12282.0,,9061.0,,3221.0,,12549,12549,9318,9304,3231,3245,3546009
3655,70238,2390,2390,1812,1846,578,544,2405.0,,2110.0,,295.0,,2207,2207,1589,1593,618,614,3546108
3656,70254,4085,4085,3238,3257,847,828,4071.0,,3461.0,,610.0,,3856,3856,3047,3045,809,811,3546207
3657,70270,21257,21257,16974,17165,4283,4092,20827.0,,16430.0,,4397.0,,20892,20892,17329,17333,3563,3559,3546306
3658,70297,35939,35939,26813,27285,9126,8654,35412.0,,25191.0,,10221.0,,34917,34917,26546,26369,8371,8548,3546405
3659,70319,5013,5013,4114,4138,899,875,4976.0,,4254.0,,722.0,,5092,5092,4017,3999,1075,1093,3546504
3660,70335,27145,27145,20154,20518,6991,6627,26767.0,,18808.0,,7959.0,,25555,25555,18527,18523,7028,7032,3546603
3661,70351,18867,18867,15276,15435,3591,3432,17917.0,,14161.0,,3756.0,,17196,17196,13854,14007,3342,3189,3546702
3662,70378,43208,43208,33919,33830,9289,9378,42613.0,,32042.0,,10571.0,,41425,41425,32327,32097,9098,9328,3546801
3663,70394,6816,6816,5355,5357,1461,1459,6885.0,,5378.0,,1507.0,,7656,7656,5793,5765,1863,1891,3546900
3664,70416,4313,4313,3311,3382,1002,931,4137.0,,3324.0,,813.0,,4135,4135,3212,3217,923,918,3547007
3665,70432,2743,2743,1975,1965,768,778,2742.0,,2177.0,,565.0,,2704,2704,1917,1903,787,801,3547106
3666,70459,1599,1599,1226,1255,373,344,1606.0,,1408.0,,198.0,,1641,1641,1218,1222,423,419,3547205
3667,70475,100466,100466,81770,82044,18696,18422,92251.0,,71314.0,,20937.0,,84675,84675,69963,69551,14712,15124,3547304
3668,70491,2489,2489,1909,1959,580,530,2480.0,,2114.0,,366.0,,2449,2449,1855,1854,594,595,3547403
3669,70513,20031,20031,15528,15773,4503,4258,19670.0,,14620.0,,5050.0,,19142,19142,15868,15813,3274,3329,3547502
3670,70530,19831,19831,14604,14845,5227,4986,19726.0,,14260.0,,5466.0,,19632,19632,14258,14246,5374,5386,3547601
3671,70556,15310,15310,12000,12272,3310,3038,14963.0,,11276.0,,3687.0,,14500,14500,11900,11894,2600,2606,3547700
3672,70572,583388,583388,461754,463545,121634,119843,568760.0,,404505.0,,164255.0,,573104,573104,451305,450417,121799,122687,3547809
3673,70599,5375,5375,4395,4447,980,928,5219.0,,4519.0,,700.0,,5053,5053,4313,4283,740,770,3547908
3674,70610,17082,17082,13407,13526,3675,3556,16831.0,,13089.0,,3742.0,,16745,16745,12806,12743,3939,4002,3548005
3675,70637,5445,5445,4116,4216,1329,1229,5432.0,,4265.0,,1167.0,,5398,5398,4180,4228,1218,1170,3548104
3676,70653,6390,6390,4957,5059,1433,1331,6231.0,,4788.0,,1443.0,,6207,6207,4710,4721,1497,1486,3548203
3677,70670,2766,2766,2155,2196,611,570,2713.0,,2275.0,,438.0,,2756,2756,2081,2070,675,686,3548302
3678,70696,3253,3253,2555,2584,698,669,3234.0,,2616.0,,618.0,,3392,3392,2621,2628,771,764,3548401
3679,70718,352595,352595,272431,273244,80164,79351,341867.0,,229006.0,,112861.0,,343758,343758,262988,263139,80770,80619,3548500
3680,70734,9551,9551,7332,7491,2219,2060,9460.0,,7099.0,,2361.0,,9381,9381,6954,6995,2427,2386,3548609
3681,70750,639960,639960,517111,518627,122849,121333,620181.0,,455094.0,,165087.0,,620982,620982,497701,495748,123281,125234,3548708
3682,70777,146410,146410,119375,120456,27035,25954,142528.0,,107565.0,,34963.0,,136028,136028,113532,112925,22496,23103,3548807
3683,70793,193957,193957,150423,150913,43534,43044,186863.0,,131005.0,,55858.0,,184522,184522,144092,142976,40430,41546,3548906
3684,70815,2530,2530,1910,1956,620,574,2568.0,,2091.0,,477.0,,2588,2588,1869,1912,719,676,3549003
3685,70831,71550,71550,54972,55824,16578,15726,70161.0,,49669.0,,20492.0,,69004,69004,53422,53125,15582,15879,3549102
3686,70858,2277,2277,1786,1824,491,453,2277.0,,1898.0,,379.0,,2396,2396,1773,1760,623,636,3549201
3687,70874,2025,2025,1623,1639,402,386,2013.0,,1733.0,,280.0,,2028,2028,1625,1617,403,411,3549300
3688,70890,38079,38079,28905,29433,9174,8646,37768.0,,27125.0,,10643.0,,36280,36280,27048,27002,9232,9278,3549409
3689,70912,6955,6955,5053,5166,1902,1789,6864.0,,5473.0,,1391.0,,7087,7087,4946,4919,2141,2168,3549508
3690,70939,3797,3797,2948,2994,849,803,3743.0,,3071.0,,672.0,,3633,3633,2758,2704,875,929,3549607
3691,70955,42715,42715,31518,32013,11197,10702,42544.0,,29645.0,,12899.0,,41616,41616,31022,31058,10594,10558,3549706
3692,70971,344514,344514,267618,271847,76896,72667,332540.0,,228368.0,,104172.0,,328658,328658,252460,252645,76198,76013,3549805
3693,70998,558140,558140,446631,449885,111509,108255,540501.0,,395291.0,,145210.0,,508693,508693,412137,408316,96556,100377,3549904
3694,71013,9986,9986,8010,8074,1976,1912,9796.0,,7948.0,,1848.0,,9452,9452,7791,7742,1661,1710,3550001
3695,71030,31134,31134,24082,24186,7052,6948,31144.0,,23179.0,,7965.0,,30744,30744,23937,23585,6807,7159,3550100
3696,71056,25689,25689,19597,19928,6092,5761,25409.0,,18927.0,,6482.0,,25199,25199,18967,19049,6232,6150,3550209
3697,71072,9314259,9314259,7333128,7366022,1981131,1948237,8986687.0,8986687.0,6354095.0,6217666.0,2632592.0,2769021.0,9052724,9052724,7135112,7128780,1917612,1923944,3550308
3698,71099,27290,27290,20733,20944,6557,6346,26120.0,,17895.0,,8225.0,,25514,25514,19680,19584,5834,5930,3550407
3699,71110,5742,5742,4467,4558,1275,1184,5673.0,,4729.0,,944.0,,5625,5625,4329,4323,1296,1302,3550506
3700,71137,63625,63625,48263,48529,15362,15096,62027.0,,43896.0,,18131.0,,59687,59687,45366,45328,14321,14359,3550605
3701,71153,66581,66581,51469,51272,15112,15309,63747.0,,48142.0,,15605.0,,60844,60844,45478,45285,15366,15559,3550704
3702,71170,8559,8559,6722,6770,1837,1789,8340.0,,6510.0,,1830.0,,8096,8096,6660,6631,1436,1465,3550803
3703,71196,12124,12124,9161,9122,2963,3002,12111.0,,8972.0,,3139.0,,12228,12228,9055,8911,3173,3317,3550902
3704,71218,259020,259020,201166,199300,57854,59720,252146.0,252146.0,180970.0,171684.0,71176.0,80462.0,254057,254057,193302,193997,60755,60060,3551009
3705,71234,7609,7609,6020,6042,1589,1567,7434.0,,5959.0,,1475.0,,7051,7051,5408,5386,1643,1665,3551108
3706,71250,3171,3171,2459,2449,712,722,3173.0,,2629.0,,544.0,,3227,3227,2416,2352,811,875,3551207
3707,71277,3025,3025,2386,2437,639,588,3014.0,,2617.0,,397.0,,2966,2966,2321,2276,645,690,3551306
3708,71293,7766,7766,5829,5844,1937,1922,7421.0,,5924.0,,1497.0,,7209,7209,5198,5237,2011,1972,3551405
3709,71315,34817,34817,26914,27288,7903,7529,33962.0,,25804.0,,8158.0,,32818,32818,24789,24709,8029,8109,3551504
3710,71331,23408,23408,17588,17735,5820,5673,23069.0,,16058.0,,7011.0,,22592,22592,16447,16505,6145,6087,3551603
3711,71358,97072,97072,75584,76327,21488,20745,95006.0,,68823.0,,26183.0,,89484,89484,67917,67747,21567,21737,3551702
3712,71374,11314,11314,7817,7838,3497,3476,11168.0,,7774.0,,3394.0,,10593,10593,7161,7042,3432,3551,3551801
3713,71390,12277,12277,9617,9790,2660,2487,12228.0,,9927.0,,2301.0,,12501,12501,9617,9603,2884,2898,3551900
3714,71412,5410,5410,4225,4292,1185,1118,5301.0,,4311.0,,990.0,,5198,5198,3995,3948,1203,1250,3552007
3715,71439,31383,31383,24073,24737,7310,6646,31015.0,,22586.0,,8429.0,,29766,29766,22076,22476,7690,7290,3552106
3716,71455,513603,513603,420665,422384,92938,91219,485962.0,485962.0,356477.0,347050.0,129485.0,138912.0,458748,458748,402557,401373,56191,57375,3552205
3717,71471,6322,6322,4841,4923,1481,1399,6279.0,,5172.0,,1107.0,,6367,6367,4916,4830,1451,1537,3552304
3718,71498,198403,198403,155913,157430,42490,40973,189410.0,,137121.0,,52289.0,,186768,186768,147538,146620,39230,40148,3552403
3719,71510,228555,228555,183376,182885,45179,45670,217959.0,,165954.0,,52005.0,,215897,215897,172192,170623,43705,45274,3552502
3720,71536,9274,9274,7314,7451,1960,1823,9276.0,,7421.0,,1855.0,,9236,9236,7222,7197,2014,2039,3552601
3721,71552,11620,11620,8835,9015,2785,2605,11621.0,,8551.0,,3070.0,,11410,11410,8539,8554,2871,2856,3552700
3722,71579,223917,223917,178721,179897,45196,44020,217479.0,217479.0,163548.0,153524.0,53931.0,63955.0,208738,208738,166071,164938,42667,43800,3552809
3723,71595,4955,4955,4162,4239,793,716,4768.0,,4316.0,,452.0,,4464,4464,3813,3794,651,670,3552908
3724,71617,9245,9245,7304,7366,1941,1879,9169.0,,7365.0,,1804.0,,9022,9022,7024,6978,1998,2044,3553005
3725,71633,4825,4825,3680,3696,1145,1129,4823.0,,3933.0,,890.0,,4860,4860,3565,3584,1295,1276,3553104
3726,71650,4763,4763,3601,3624,1162,1139,4716.0,,3799.0,,917.0,,4672,4672,3464,3484,1208,1188,3553203
3727,71676,15951,15951,12677,12817,3274,3134,15564.0,,12517.0,,3047.0,,15007,15007,12549,12570,2458,2437,3553302
3728,71692,20685,20685,16003,16227,4682,4458,20661.0,,15737.0,,4924.0,,20253,20253,15218,15199,5035,5054,3553401
3729,71714,6545,6545,4607,4731,1938,1814,6478.0,,4718.0,,1760.0,,6434,6434,4490,4483,1944,1951,3553500
3730,71730,10480,10480,7953,8027,2527,2453,10426.0,,7905.0,,2521.0,,10503,10503,8022,7896,2481,2607,3553609
3731,71757,40780,40780,30145,30739,10635,10041,40594.0,,28678.0,,11916.0,,40202,40202,29204,29142,10998,11060,3553708
3732,71773,17401,17401,14096,14193,3305,3208,16998.0,,13556.0,,3442.0,,16312,16312,14055,13921,2257,2391,3553807
3733,71790,5614,5614,4255,4340,1359,1274,5584.0,,4374.0,,1210.0,,5572,5572,4208,4141,1364,1431,3553906
3734,71811,92635,92635,69188,70374,23447,22261,90608.0,,62254.0,,28354.0,,85353,85353,65069,65056,20284,20297,3554003
3735,71838,238529,238529,185642,187707,52887,50822,229200.0,229200.0,162008.0,156827.0,67192.0,72373.0,228875,228875,178526,178102,50349,50773,3554102
3736,71854,3747,3747,2815,2823,932,924,3776.0,,3052.0,,724.0,,3910,3910,2853,2860,1057,1050,3554201
3737,71870,18342,18342,13258,13516,5084,4826,18122.0,,13446.0,,4676.0,,17586,17586,12681,12502,4905,5084,3554300
3738,71897,6054,6054,5053,5125,1001,929,5889.0,,5163.0,,726.0,,5664,5664,4854,4974,810,690,3554409
3739,71919,30783,30783,23693,23903,7090,6880,30332.0,,21525.0,,8807.0,,29849,29849,23293,23214,6556,6635,3554508
3740,71935,2413,2413,1854,1835,559,578,2436.0,,2019.0,,417.0,,2417,2417,1839,1788,578,629,3554607
3741,71951,7379,7379,5710,5723,1669,1656,7346.0,,5628.0,,1718.0,,7362,7362,5700,5637,1662,1725,3554706
3742,71978,30288,30288,23690,23833,6598,6455,29336.0,,21579.0,,7757.0,,26869,26869,20944,20861,5925,6008,3554805
3743,71994,5144,5144,3806,3891,1338,1253,5097.0,,3751.0,,1346.0,,5073,5073,3753,3734,1320,1339,3554904
3744,72010,50636,50636,37582,38152,13054,12484,50967.0,,35167.0,,15800.0,,50791,50791,37134,37002,13657,13789,3555000
3745,72036,11460,11460,8728,8860,2732,2600,11368.0,,8651.0,,2717.0,,11542,11542,8691,8679,2851,2863,3555109
3746,72052,1692,1692,1292,1327,400,365,1696.0,,1450.0,,246.0,,1731,1731,1280,1279,451,452,3555208
3747,72079,1872,1872,1432,1450,440,422,1851.0,,1596.0,,255.0,,1969,1969,1422,1377,547,592,3555307
3748,72095,76224,76224,56432,56797,19792,19427,72678.0,,50665.0,,22013.0,,68789,68789,50527,49992,18262,18797,3555406
3749,72117,4194,4194,3174,3223,1020,971,4170.0,,3417.0,,753.0,,4157,4157,3148,3093,1009,1064,3555505
3750,72133,8083,8083,6404,6471,1679,1612,8017.0,,6436.0,,1581.0,,7987,7987,6250,6224,1737,1763,3555604
3751,72150,1616,1616,1234,1229,382,387,1670.0,,1422.0,,248.0,,1698,1698,1179,1187,519,511,3555703
3752,72176,6896,6896,5497,5597,1399,1299,6840.0,,5504.0,,1336.0,,6592,6592,5080,5073,1512,1519,3555802
3753,72192,1513,1513,1193,1177,320,336,1533.0,,1386.0,,147.0,,1448,1448,1106,1076,342,372,3555901
3754,72214,11184,11184,8389,8646,2795,2538,11126.0,,7956.0,,3170.0,,11019,11019,8083,8145,2936,2874,3556008
3755,72230,10234,10234,8022,8185,2212,2049,10096.0,,7720.0,,2376.0,,9571,9571,7154,7215,2417,2356,3556107
3756,72257,96405,96405,75473,76775,20932,19630,93193.0,,65173.0,,28020.0,,89688,89688,70438,70724,19250,18964,3556206
3757,72273,16887,16887,12412,12769,4475,4118,16791.0,,12407.0,,4384.0,,16116,16116,11507,11671,4609,4445,3556305
3758,72311,32115,32115,24412,24803,7703,7312,31821.0,,23181.0,,8640.0,,31223,31223,23682,23779,7541,7444,3556404
3759,72338,83504,83504,68053,68154,15451,15350,79011.0,,60464.0,,18547.0,,74333,74333,64215,64125,10118,10208,3556503
3760,72354,7796,7796,6398,6476,1398,1320,7608.0,,6207.0,,1401.0,,7093,7093,6288,6247,805,846,3556602
3761,72370,63005,63005,50616,51435,12389,11570,59983.0,,43330.0,,16653.0,,58263,58263,47427,47648,10836,10615,3556701
3762,72397,12921,12921,10740,10929,2181,1992,12576.0,,10415.0,,2161.0,,12035,12035,10404,10455,1631,1580,3556800
3763,72419,6139,6139,4762,4867,1377,1272,6091.0,,4952.0,,1139.0,,5472,5472,4239,4276,1233,1196,3556909
3764,72435,90853,90853,73271,73793,17582,17060,86783.0,,63641.0,,23142.0,,81985,81985,71296,71290,10689,10695,3557006
3765,72451,72777,72777,55602,56696,17175,16081,71543.0,,49255.0,,22288.0,,69691,69691,52500,52486,17191,17205,3557105
3766,72737,40807,40807,32754,32808,8053,7999,39200.0,,31283.0,,7917.0,,38053,38053,30443,30091,7610,7962,3556453
3767,73008,2340,2340,1900,1816,440,524,2239.0,,1985.0,,254.0,,2079,2079,1624,1451,455,628,1700251
3768,73016,2193,2193,1805,1665,388,528,2215.0,,1979.0,,236.0,,2124,2124,1773,1558,351,566,1717206
3769,73024,3608,3608,2914,2763,694,845,3678.0,,3358.0,,320.0,,3230,3230,2699,2510,531,720,1718550
3770,73032,4104,4104,3303,3181,801,923,3962.0,,3308.0,,654.0,,3883,3883,3153,3020,730,863,1706506
3771,73040,4093,4093,3352,3166,741,927,4021.0,,3536.0,,485.0,,3740,3740,3143,2906,597,834,1713809
3772,73059,3187,3187,2604,2516,583,671,2925.0,,2657.0,,268.0,,2637,2637,2229,2096,408,541,1712801
3773,73067,1859,1859,1459,1352,400,507,1927.0,,1714.0,,213.0,,1808,1808,1442,1271,366,537,1703826
3774,73075,2683,2683,2126,1969,557,714,2623.0,,2406.0,,217.0,,2343,2343,1961,1780,382,563,1701051
3775,73083,3751,3751,3098,2916,653,835,3694.0,,3296.0,,398.0,,3294,3294,2783,2557,511,737,1715705
3776,73091,6085,6085,5099,4900,986,1185,5941.0,,5427.0,,514.0,,5291,5291,4479,4224,812,1067,1703842
3777,73105,1606,1606,1288,1142,318,464,1554.0,,1434.0,,120.0,,1383,1383,1047,884,336,499,1720150
3778,73113,2992,2992,2466,2367,526,625,2904.0,,2610.0,,294.0,,2771,2771,2264,1927,507,844,1711951
3779,73121,3215,3215,2661,2608,554,607,3104.0,,2689.0,,415.0,,3034,3034,2457,2293,577,741,1703305
3780,73130,2519,2519,2046,1928,473,591,2520.0,,2270.0,,250.0,,2235,2235,1821,1600,414,635,1718881
3781,73148,2056,2056,1638,1514,418,542,2132.0,,1940.0,,192.0,,1866,1866,1425,1286,441,580,1715150
3782,73156,3346,3346,2718,2593,628,753,3207.0,,2773.0,,434.0,,3042,3042,2386,2217,656,825,1718840
3783,73164,1931,1931,1412,1343,519,588,1845.0,,1639.0,,206.0,,1734,1734,1313,1166,421,568,1720937
3784,73172,2136,2136,1718,1667,418,469,2046.0,,1882.0,,164.0,,1997,1997,1558,1405,439,592,1715259
3785,73180,7802,7802,6671,6499,1131,1303,7226.0,,6510.0,,716.0,,6781,6781,5943,5745,838,1036,1720200
3786,73199,3063,3063,2444,2405,619,658,2965.0,,2622.0,,343.0,,2720,2720,2176,1932,544,788,1708254
3787,73202,3253,3253,2692,2578,561,675,3161.0,,2858.0,,303.0,,2728,2728,2295,2133,433,595,1710904
3788,73210,1817,1817,1542,1432,275,385,1772.0,,1667.0,,105.0,,1648,1648,1422,1266,226,382,1704105
3789,73229,2837,2837,2354,2232,483,605,2666.0,,2476.0,,190.0,,2377,2377,2016,1908,361,469,1718501
3790,73237,1849,1849,1436,1363,413,486,1838.0,,1639.0,,199.0,,1790,1790,1376,1245,414,545,1721307
3791,73245,1802,1802,1515,1428,287,374,1777.0,,1646.0,,131.0,,1677,1677,1424,1277,253,400,1703602
3792,73253,2039,2039,1721,1606,318,433,2018.0,,1845.0,,173.0,,1943,1943,1555,1405,388,538,1711803
3793,73261,3392,3392,2710,2552,682,840,3305.0,,2825.0,,480.0,,3362,3362,2742,2491,620,871,1716307
3794,73270,1964,1964,1615,1565,349,399,1829.0,,1678.0,,151.0,,1706,1706,1381,1298,325,408,1712702
3795,73288,4514,4514,3627,3379,887,1135,4268.0,,3840.0,,428.0,,4015,4015,3336,2945,679,1070,1720101
3796,73296,6018,6018,4745,4601,1273,1417,5758.0,,4860.0,,898.0,,5707,5707,4587,4401,1120,1306,1707405
3797,73300,3505,3505,2839,2767,666,738,3474.0,,3105.0,,369.0,,3171,3171,2477,2318,694,853,1703867
3798,73318,3566,3566,2890,2733,676,833,3507.0,,2993.0,,514.0,,3441,3441,2844,2622,597,819,1702158
3799,73326,2334,2334,1914,1834,420,500,2074.0,,1839.0,,235.0,,1964,1964,1656,1539,308,425,1703883
3800,73334,4442,4442,3642,3464,800,978,4123.0,,3575.0,,548.0,,4029,4029,3310,3044,719,985,1701309
3801,73342,2652,2652,2212,2094,440,558,2593.0,,2367.0,,226.0,,2165,2165,1847,1682,318,483,1713957
3802,73350,5149,5149,4189,4040,960,1109,4787.0,,4140.0,,647.0,,4501,4501,3789,3446,712,1055,1718865
3803,73369,2822,2822,2241,2169,581,653,2724.0,,2418.0,,306.0,,2562,2562,2078,1945,484,617,1711506
3804,73377,1623,1623,1365,1311,258,312,1554.0,,1430.0,,124.0,,1525,1525,1261,1164,264,361,1720853
3805,73385,8516,8516,6816,6684,1700,1832,8019.0,,6796.0,,1223.0,,8093,8093,6293,5850,1800,2243,1711902
3806,73393,2370,2370,1773,1672,597,698,2381.0,,2111.0,,270.0,,2258,2258,1653,1482,605,776,1720259
3807,73407,3279,3279,2589,2472,690,807,3323.0,,2888.0,,435.0,,3290,3290,2576,2227,714,1063,1712009
3808,73415,2502,2502,2035,1944,467,558,2431.0,,2184.0,,247.0,,2194,2194,1728,1578,466,616,1718709
3809,73423,3063,3063,2432,2239,631,824,2878.0,,2525.0,,353.0,,2754,2754,2227,2027,527,727,1703891
3810,73431,2046,2046,1564,1466,482,580,1938.0,,1784.0,,154.0,,1791,1791,1370,1199,421,592,1718659
3811,73440,198215,198215,164337,162166,33878,36049,180524.0,,138531.0,,41993.0,,185254,185254,147956,141036,37298,44218,1721000
3812,73458,1889,1889,1543,1447,346,442,1929.0,,1714.0,,215.0,,1789,1789,1437,1264,352,525,1721257
3813,73466,1587,1587,1220,1176,367,411,1611.0,,1452.0,,159.0,,1595,1595,1257,1084,338,511,1715507
3814,73474,2194,2194,1805,1698,389,496,2160.0,,1997.0,,163.0,,1931,1931,1566,1304,365,627,1704600
3815,73482,2771,2771,2233,2112,538,659,2654.0,,2327.0,,327.0,,2629,2629,2085,1849,544,780,1705102
3816,73504,2561,2561,1985,1905,576,656,2566.0,,2219.0,,347.0,,2395,2395,1822,1647,573,748,1720978
3817,73512,3752,3752,3066,2988,686,764,3435.0,,2987.0,,448.0,,3459,3459,2910,2774,549,685,1700301
3818,73520,2456,2456,2074,1931,382,525,2280.0,,2081.0,,199.0,,2107,2107,1819,1597,288,510,1712454
3819,73539,2051,2051,1720,1639,331,412,2003.0,,1830.0,,173.0,,1857,1857,1602,1466,255,391,1720002
3820,73547,2018,2018,1672,1551,346,467,1963.0,,1812.0,,151.0,,1785,1785,1409,1213,376,572,1718899
3821,73555,1599,1599,1324,1289,275,310,1523.0,,1419.0,,104.0,,1404,1404,1126,974,278,430,1706258
3822,73563,2376,2376,1938,1892,438,484,2285.0,,2012.0,,273.0,,2306,2306,1848,1668,458,638,1713700
3823,73571,2047,2047,1666,1620,381,427,1928.0,,1710.0,,218.0,,1914,1914,1475,1315,439,599,1718451
3824,73580,2636,2636,2225,2131,411,505,2632.0,,2431.0,,201.0,,2359,2359,1985,1818,374,541,1703057
3825,73598,1688,1688,1455,1322,233,366,1616.0,,1506.0,,110.0,,1504,1504,1272,1078,232,426,1709807
3826,73601,1772,1772,1436,1336,336,436,1738.0,,1601.0,,137.0,,1624,1624,1306,1126,318,498,1712157
3827,73610,3604,3604,2916,2748,688,856,3539.0,,3104.0,,435.0,,3407,3407,2809,2556,598,851,1703073
3828,74004,2738,2738,2153,2137,585,601,2712.0,,2346.0,,366.0,,2569,2569,2200,2142,369,427,4108551
3829,74012,5954,5954,4570,4702,1384,1252,5822.0,,4743.0,,1079.0,,5748,5748,4884,4862,864,886,4100103
3830,74020,5190,5190,3958,3978,1232,1212,5215.0,,4186.0,,1029.0,,5059,5059,3801,3722,1258,1337,4109757
3831,74039,5454,5454,4303,4121,1151,1333,5269.0,,4348.0,,921.0,,5080,5080,4004,3920,1076,1160,4100202
3832,74047,4980,4980,4002,4005,978,975,4872.0,,4190.0,,682.0,,4595,4595,3796,3753,799,842,4113452
3833,74055,8009,8009,6642,6600,1367,1409,7516.0,,6538.0,,978.0,,6869,6869,5798,5765,1071,1104,4100301
3834,74063,4945,4945,4058,4066,887,879,4812.0,,4145.0,,667.0,,4553,4553,3833,3814,720,739,4117453
3835,74071,75204,75204,60045,60400,15159,14804,70987.0,,54566.0,,16421.0,,68021,68021,56838,56554,11183,11467,4100400
3836,74080,9428,9428,7588,7624,1840,1804,9115.0,,7584.0,,1531.0,,8678,8678,7110,7106,1568,1572,4124020
3837,74098,10853,10853,8314,8566,2539,2287,10727.0,,8301.0,,2426.0,,10357,10357,7963,7917,2394,2440,4100608
3838,74101,2697,2697,2192,2246,505,451,2691.0,,2383.0,,308.0,,2641,2641,2159,2100,482,541,4101051
3839,74110,7406,7406,5746,5869,1660,1537,7276.0,,5998.0,,1278.0,,7099,7099,5816,5910,1283,1189,4100707
3840,74128,2643,2643,2230,2241,413,402,2592.0,,2312.0,,280.0,,2477,2477,2126,2092,351,385,4101150
3841,74136,7040,7040,5617,5743,1423,1297,6946.0,,5499.0,,1447.0,,6733,6733,5714,5642,1019,1091,4100806
3842,74144,2275,2275,1986,1962,289,313,2273.0,,2083.0,,190.0,,2323,2323,1938,1863,385,460,4103024
3843,74152,3956,3956,3253,3276,703,680,3879.0,,3334.0,,545.0,,3808,3808,3208,3230,600,578,4100905
3844,74160,2998,2998,2514,2513,484,485,2972.0,,2536.0,,436.0,,2921,2921,2479,2433,442,488,4103222
3845,74179,14929,14929,12209,12381,2720,2548,14808.0,,12307.0,,2501.0,,13777,13777,11242,11227,2535,2550,4101002
3846,74187,3081,3081,2526,2547,555,534,2985.0,,2696.0,,289.0,,2746,2746,2358,2348,388,398,4103370
3847,74195,16549,16549,12901,13092,3648,3457,16443.0,,12587.0,,3856.0,,16359,16359,13149,13175,3210,3184,4101101
3848,74209,4064,4064,3284,3293,780,771,4009.0,,3395.0,,614.0,,3653,3653,3097,3063,556,590,4103479
3849,74217,15484,15484,11898,11962,3586,3522,14893.0,,11406.0,,3487.0,,14602,14602,11700,11573,2902,3029,4101200
3850,74225,11618,11618,9373,9372,2245,2246,11298.0,,9554.0,,1744.0,,11044,11044,9134,8981,1910,2063,4104428
3851,74233,6660,6660,5397,5469,1263,1191,6372.0,,5475.0,,897.0,,6271,6271,5302,5278,969,993,4101309
3852,74241,3630,3630,2996,2945,634,685,3628.0,,3069.0,,559.0,,3564,3564,2825,2804,739,760,4106571
3853,74250,94621,94621,75518,76619,19103,18002,91751.0,,67464.0,,24287.0,,91302,91302,74963,75055,16339,16247,4101408
3854,74268,3243,3243,2493,2405,750,838,3154.0,,2804.0,,350.0,,2883,2883,2360,2248,523,635,4107124
3855,74276,82690,82690,67205,68731,15485,13959,79682.0,,60824.0,,18858.0,,77060,77060,65968,66728,11092,10332,4101507
3856,74284,3598,3598,3097,3058,501,540,3528.0,,3111.0,,417.0,,3370,3370,2813,2801,557,569,4107538
3857,74292,19337,19337,15020,15296,4317,4041,18769.0,,14505.0,,4264.0,,18387,18387,15317,15169,3070,3218,4101606
3858,74306,2751,2751,2284,2300,467,451,2700.0,,2356.0,,344.0,,2692,2692,2263,2288,429,404,4107553
3859,74314,11257,11257,9014,9133,2243,2124,11190.0,,9154.0,,2036.0,,10718,10718,8538,8506,2180,2212,4101705
3860,74322,83629,83629,65498,66129,18131,17500,75330.0,,55080.0,,20250.0,,70041,70041,57073,56876,12968,13165,4107652
3861,74330,7245,7245,5792,5804,1453,1441,7118.0,,5858.0,,1260.0,,7013,7013,5831,5770,1182,1243,4114906
3862,74349,4485,4485,3751,3726,734,759,4446.0,,4030.0,,416.0,,4210,4210,3767,3681,443,529,4107850
3863,74357,104811,104811,85860,86409,18951,18402,98733.0,,76228.0,,22505.0,,94423,94423,79536,79466,14887,14957,4101804
3864,74365,4290,4290,3547,3527,743,763,4255.0,,3729.0,,526.0,,4029,4029,3456,3396,573,633,4109658
3865,74373,12519,12519,9764,9899,2755,2620,12275.0,,9805.0,,2470.0,,12135,12135,10141,10084,1994,2051,4101903
3866,74381,2007,2007,1660,1675,347,332,1997.0,,1808.0,,189.0,,2028,2028,1655,1640,373,388,4110052
3867,74390,20862,20862,16090,16631,4772,4231,20749.0,,15783.0,,4966.0,,20789,20789,16222,16236,4567,4553,4102109
3868,74403,2389,2389,1895,1916,494,473,2372.0,,2060.0,,312.0,,2376,2376,1848,1841,528,535,4110656
3869,74411,3566,3566,2944,2982,622,584,3551.0,,3138.0,,413.0,,3536,3536,2918,2891,618,645,4102208
3870,74420,2798,2798,2404,2393,394,405,2782.0,,2513.0,,269.0,,2589,2589,2266,2235,323,354,4117297
3871,74438,11586,11586,9565,9691,2021,1895,11454.0,,9553.0,,1901.0,,11181,11181,9422,9309,1759,1872,4102307
3872,74446,20201,20201,17328,17557,2873,2644,19603.0,,17484.0,,2119.0,,18945,18945,16306,16382,2639,2563,4111258
3873,74454,25069,25069,19537,19854,5532,5215,24642.0,,19048.0,,5594.0,,24464,24464,20556,20301,3908,4163,4102406
3874,74462,5704,5704,4515,4585,1189,1119,5782.0,,4753.0,,1029.0,,5637,5637,4629,4564,1008,1073,4111555
3875,74470,8889,8889,6716,6802,2173,2087,8757.0,,6878.0,,1879.0,,8621,8621,6862,6829,1759,1792,4102505
3876,74489,3527,3527,2679,2760,848,767,3491.0,,2782.0,,709.0,,3522,3522,2644,2640,878,882,4113429
3877,74497,7549,7549,6072,6135,1477,1414,7342.0,,6204.0,,1138.0,,7059,7059,5999,5806,1060,1253,4102604
3878,74500,5110,5110,4269,4333,841,777,5086.0,,4318.0,,768.0,,5070,5070,4357,4311,713,759,4115358
3879,74519,2624,2624,2173,2157,451,467,2614.0,,2321.0,,293.0,,2510,2510,2114,2071,396,439,4102703
3880,74527,3284,3284,2615,2645,669,639,3243.0,,2774.0,,469.0,,3086,3086,2412,2413,674,673,4115739
3881,74535,12536,12536,9924,10097,2612,2439,12357.0,,9788.0,,2569.0,,12114,12114,9988,10134,2126,1980,4102802
3882,74543,7345,7345,5947,5822,1398,1523,7131.0,,5992.0,,1139.0,,6898,6898,5949,5833,949,1065,4115754
3883,74551,12098,12098,10059,9960,2039,2138,11870.0,,10258.0,,1612.0,,11491,11491,10011,9900,1480,1591,4102901
3884,74560,4787,4787,4108,4128,679,659,4704.0,,4211.0,,493.0,,4546,4546,3909,3873,637,673,4115853
3885,74578,3830,3830,3143,3208,687,622,3768.0,,3326.0,,442.0,,3651,3651,3179,3158,472,493,4103008
3886,74586,8001,8001,6455,6539,1546,1462,7666.0,,6625.0,,1041.0,,7503,7503,6341,6308,1162,1195,4117057
3887,74594,9728,9728,7604,7704,2124,2024,9339.0,,7362.0,,1977.0,,9117,9117,7247,7184,1870,1933,4103107
3888,74608,3607,3607,2860,2824,747,783,3499.0,,2964.0,,535.0,,3315,3315,2808,2777,507,538,4117214
3889,74616,5247,5247,4296,4296,951,951,5108.0,,4382.0,,726.0,,4904,4904,4241,4202,663,702,4103206
3890,74624,4443,4443,3769,3732,674,711,4376.0,,3796.0,,580.0,,4239,4239,3574,3535,665,704,4118451
3891,74632,6644,6644,5292,5308,1352,1336,6721.0,,5422.0,,1299.0,,6570,6570,5092,5080,1478,1490,4103305
3892,74640,2212,2212,1939,1952,273,260,2175.0,,2052.0,,123.0,,2104,2104,1909,1887,195,217,4119251
3893,74659,2181,2181,1875,1880,306,301,2143.0,,1934.0,,209.0,,2086,2086,1811,1784,275,302,4103404
3894,74667,2600,2600,2063,2106,537,494,2584.0,,2248.0,,336.0,,2557,2557,2117,2076,440,481,4119657
3895,74675,6876,6876,5688,5768,1188,1108,6682.0,,5532.0,,1150.0,,6567,6567,5662,5655,905,912,4103503
3896,74683,3802,3802,3285,3322,517,480,3698.0,,3213.0,,485.0,,3559,3559,3054,3022,505,537,4120853
3897,74691,18135,18135,14105,14376,4030,3759,17888.0,,13674.0,,4214.0,,17827,17827,14674,14706,3153,3121,4103602
3898,74705,3598,3598,2753,2743,845,855,3434.0,,2853.0,,581.0,,3473,3473,2601,2573,872,900,4121257
3899,74713,74167,74167,60096,61047,14071,13120,70817.0,,52196.0,,18621.0,,69287,69287,58749,59056,10538,10231,4103701
3900,74721,2422,2422,1890,1942,532,480,2444.0,,2113.0,,331.0,,2515,2515,1953,1908,562,607,4121356
3901,74730,6156,6156,5129,5210,1027,946,5918.0,,5126.0,,792.0,,5742,5742,4857,4923,885,819,4103800
3902,74748,11048,11048,9029,8745,2019,2303,10784.0,,9281.0,,1503.0,,10645,10645,8974,8921,1671,1724,4122156
3903,74756,12321,12321,9502,9690,2819,2631,11966.0,,9708.0,,2258.0,,11810,11810,9469,9433,2341,2377,4103909
3904,74764,3308,3308,2617,2641,691,667,3322.0,,2837.0,,485.0,,3299,3299,2557,2551,742,748,4123824
3905,74772,33402,33402,27085,27400,6317,6002,31796.0,,24534.0,,7262.0,,30784,30784,25610,25498,5174,5286,4104006
3906,74780,3622,3622,2936,2954,686,668,3578.0,,3182.0,,396.0,,3498,3498,2877,2873,621,625,4104055
3907,74799,6103,6103,5123,5110,980,993,5961.0,,5293.0,,668.0,,5675,5675,4928,4897,747,778,4104105
3908,74802,8795,8795,6492,6514,2303,2281,8771.0,,6886.0,,1885.0,,8627,8627,6164,6157,2463,2470,4123857
3909,74810,91263,91263,74990,75615,16273,15648,87489.0,,66290.0,,21199.0,,86319,86319,72416,72176,13903,14143,4104204
3910,74829,2713,2713,2195,2202,518,511,2660.0,,2419.0,,241.0,,2506,2506,2101,2126,405,380,4123956
3911,74837,69057,69057,55906,56680,13151,12377,65951.0,,51158.0,,14793.0,,64311,64311,54157,54166,10154,10145,4104303
3912,74845,1976,1976,1622,1648,354,328,1978.0,,1783.0,,195.0,,1835,1835,1598,1582,237,253,4125555
3913,74853,11638,11638,9219,9185,2419,2453,11367.0,,9351.0,,2016.0,,11209,11209,9471,9484,1738,1725,4104402
3914,74861,5048,5048,4015,4075,1033,973,4997.0,,4165.0,,832.0,,5017,5017,4160,4124,857,893,4125753
3915,74870,15873,15873,12373,12622,3500,3251,15707.0,,12506.0,,3201.0,,15361,15361,11929,11919,3432,3442,4104501
3916,74888,5270,5270,4161,4156,1109,1114,5198.0,,4445.0,,753.0,,4946,4946,3943,3851,1003,1095,4127882
3917,74896,12380,12380,9394,9535,2986,2845,12273.0,,9698.0,,2575.0,,12053,12053,8929,9066,3124,2987,4104600
3918,74900,7292,7292,6138,6162,1154,1130,7068.0,,6127.0,,941.0,,6802,6802,5887,5798,915,1004,4128534
3919,74918,11918,11918,9181,9389,2737,2529,11422.0,,8763.0,,2659.0,,11237,11237,9158,9170,2079,2067,4104709
3920,74926,3003,3003,2282,2278,721,725,2982.0,,2615.0,,367.0,,2732,2732,2304,2225,428,507,4128625
3921,74934,233753,233753,190141,192415,43612,41338,223090.0,,168713.0,,54377.0,,218448,218448,182086,182410,36362,36038,4104808
3922,74942,4873,4873,3993,4030,880,843,4694.0,,4173.0,,521.0,,4425,4425,3685,3591,740,834,4128633
3923,74950,54475,54475,44717,45053,9758,9422,52265.0,,41427.0,,10838.0,,51385,51385,43716,43422,7669,7963,4104907
3924,74969,3491,3491,2912,2906,579,585,3443.0,,3115.0,,328.0,,3313,3313,2864,2829,449,484,4128658
3925,74977,7436,7436,5570,5597,1866,1839,7353.0,,5648.0,,1705.0,,7222,7222,5344,5274,1878,1948,4105003
3926,74985,4640,4640,3636,3592,1004,1048,4559.0,,3900.0,,659.0,,4293,4293,3597,3567,696,726,4113254
3927,74993,8635,8635,6823,6905,1812,1730,8510.0,,6959.0,,1551.0,,8479,8479,7009,6989,1470,1490,4105102
3928,75000,9326,9326,7680,7741,1646,1585,9094.0,,7946.0,,1148.0,,8932,8932,7121,7058,1811,1874,4110953
3929,75019,13224,13224,10566,10671,2658,2553,12853.0,,10756.0,,2097.0,,12472,12472,10424,10256,2048,2216,4105201
3930,75027,4660,4660,4008,3983,652,677,4548.0,,4097.0,,451.0,,4441,4441,3879,3894,562,547,4116950
3931,75035,16685,16685,13569,13735,3116,2950,16059.0,,13478.0,,2581.0,,15879,15879,13329,13277,2550,2602,4105409
3932,75043,94959,94959,77410,77752,17549,17207,89723.0,,66580.0,,23143.0,,85561,85561,72382,72098,13179,13463,4119152
3933,75051,57869,57869,45689,46773,12180,11096,56340.0,,43332.0,,13008.0,,54869,54869,45628,45786,9241,9083,4105508
3934,75060,5238,5238,4284,4256,954,982,4902.0,,4306.0,,596.0,,4517,4517,3815,3773,702,744,4126272
3935,75078,9324,9324,7085,7143,2239,2181,9234.0,,7249.0,,1985.0,,9280,9280,7045,6978,2235,2302,4105607
3936,75086,2325,2325,1923,1891,402,434,2254.0,,2040.0,,214.0,,2074,2074,1832,1792,242,282,4101853
3937,75094,13134,13134,10262,10314,2872,2820,12907.0,,10255.0,,2652.0,,12680,12680,10210,10159,2470,2521,4105706
3938,75108,3210,3210,2639,2622,571,588,3183.0,,2775.0,,408.0,,3228,3228,2602,2578,626,650,4101655
3939,75116,13471,13471,10922,10977,2549,2494,12945.0,,10926.0,,2019.0,,12639,12639,10694,10666,1945,1973,4114401
3940,75124,2961,2961,2490,2498,471,463,2924.0,,2699.0,,225.0,,2793,2793,2462,2447,331,346,4102752
3941,75132,156027,156027,127085,128009,28942,28018,147388.0,,110939.0,,36449.0,,142374,142374,120925,119931,21449,22443,4105805
3942,75140,5047,5047,4189,4161,858,886,5060.0,,4375.0,,685.0,,4864,4864,3975,3963,889,901,4103040
3943,75159,19324,19324,14852,15170,4472,4154,19077.0,,14672.0,,4405.0,,18843,18843,14356,14297,4487,4546,4105904
3944,75167,3498,3498,2981,2963,517,535,3401.0,,3067.0,,334.0,,3371,3371,3009,2859,362,512,4103156
3945,75175,6580,6580,5164,5185,1416,1395,6383.0,,5289.0,,1094.0,,6419,6419,5220,5258,1199,1161,4106001
3946,75183,3642,3642,2861,2856,781,786,3506.0,,3030.0,,476.0,,3331,3331,2759,2757,572,574,4103958
3947,75191,2985,2985,2395,2396,590,589,2975.0,,2590.0,,385.0,,2806,2806,2390,2362,416,444,4106100
3948,75205,20105,20105,16577,16599,3528,3506,19314.0,,15963.0,,3351.0,,18293,18293,15713,15526,2580,2767,4104253
3949,75213,12821,12821,10695,10861,2126,1960,12362.0,,10395.0,,1967.0,,12146,12146,10410,10417,1736,1729,4106209
3950,75221,16445,16445,13750,13940,2695,2505,15851.0,,13175.0,,2676.0,,15457,15457,13619,13569,1838,1888,4104659
3951,75230,14364,14364,11428,11618,2936,2746,14113.0,,10960.0,,3153.0,,13875,13875,11227,11159,2648,2716,4106308
3952,75248,5081,5081,3998,4000,1083,1081,5027.0,,4346.0,,681.0,,4868,4868,3908,3941,960,927,4106456
3953,75256,35577,35577,28525,28998,7052,6579,34698.0,,27106.0,,7592.0,,34219,34219,29328,29200,4891,5019,4106407
3954,75264,2833,2833,2173,2183,660,650,2854.0,,2389.0,,465.0,,2906,2906,2136,2129,770,777,4106852
3955,75272,17429,17429,14291,14515,3138,2914,16987.0,,13842.0,,3145.0,,16877,16877,14428,14381,2449,2496,4106506
3956,75280,3591,3591,2816,2845,775,746,3562.0,,3060.0,,502.0,,3279,3279,2694,2683,585,596,4106555
3957,75299,17331,17331,13036,13390,4295,3941,17149.0,,12721.0,,4428.0,,16695,16695,12837,12863,3858,3832,4106605
3958,75302,2044,2044,1616,1628,428,416,2086.0,,1936.0,,150.0,,1774,1774,1516,1503,258,271,4107520
3959,75310,4000,4000,3179,3280,821,720,3922.0,,3278.0,,644.0,,3845,3845,3296,3306,549,539,4106704
3960,75329,4389,4389,3330,3318,1059,1071,4389.0,,3667.0,,722.0,,4413,4413,3336,3213,1077,1200,4107546
3961,75337,13630,13630,11262,11283,2368,2347,13258.0,,11241.0,,2017.0,,13092,13092,11453,11474,1639,1618,4106803
3962,75345,5357,5357,4508,4503,849,854,5295.0,,4601.0,,694.0,,5169,5169,4443,4379,726,790,4107736
3963,75353,1413413,1413413,1151187,1160813,262226,252600,1349888.0,,942467.0,,407421.0,,1338335,1338335,1112082,1106986,226253,231349,4106902
3964,75361,4372,4372,3384,3314,988,1058,4281.0,,3697.0,,584.0,,3946,3946,3173,3068,773,878,4108452
3965,75370,10798,10798,8194,8418,2604,2380,10468.0,,7986.0,,2482.0,,10376,10376,8282,8232,2094,2144,4107009
3966,75388,5320,5320,4263,4203,1057,1117,5200.0,,4615.0,,585.0,,4989,4989,4246,4191,743,798,4108650
3967,75396,4562,4562,3475,3513,1087,1049,4646.0,,3775.0,,871.0,,4530,4530,3413,3386,1117,1144,4107108
3968,75400,3809,3809,3007,3017,802,792,3801.0,,3178.0,,623.0,,3829,3829,2918,2905,911,924,4107157
3969,75418,32691,32691,26774,27077,5917,5614,31699.0,,25474.0,,6225.0,,30289,30289,24274,24417,6015,5872,4107207
3970,75426,6468,6468,5558,5594,910,874,6284.0,,5494.0,,790.0,,6231,6231,5444,5517,787,714,4108957
3971,75434,5114,5114,4142,4209,972,905,5046.0,,4150.0,,896.0,,4975,4975,3989,4025,986,950,4107306
3972,75442,8344,8344,6945,6957,1399,1387,8083.0,,6984.0,,1099.0,,7689,7689,6688,6651,1001,1038,4110078
3973,75450,5443,5443,4469,4505,974,938,5393.0,,4676.0,,717.0,,5278,5278,4206,4239,1072,1039,4107405
3974,75469,2970,2970,2473,2391,497,579,2990.0,,2736.0,,254.0,,2811,2811,2218,2165,593,646,4114351
3975,75477,10835,10835,8341,8432,2494,2403,10832.0,,8444.0,,2388.0,,10933,10933,8237,8139,2696,2794,4107504
3976,75485,3727,3727,3130,3051,597,676,3685.0,,3251.0,,434.0,,3595,3595,3016,2984,579,611,4115457
3977,75493,12670,12670,9713,9788,2957,2882,12687.0,,9574.0,,3113.0,,12194,12194,9443,9323,2751,2871,4107603
3978,75507,5380,5380,4317,4393,1063,987,5312.0,,4377.0,,935.0,,5165,5165,4251,4305,914,860,4118857
3979,75515,4087,4087,3138,3142,949,945,4093.0,,3469.0,,624.0,,3975,3975,3065,3007,910,968,4107702
3980,75523,21326,21326,16215,16156,5111,5170,18981.0,,14614.0,,4367.0,,16655,16655,13661,13522,2994,3133,4119954
3981,75531,4439,4439,3748,3787,691,652,4489.0,,3940.0,,549.0,,4407,4407,3749,3669,658,738,4107801
3982,75540,3112,3112,2611,2533,501,579,3137.0,,2860.0,,277.0,,2902,2902,2504,2471,398,431,4120150
3983,75558,6972,6972,5717,5740,1255,1232,6516.0,,5560.0,,956.0,,5787,5787,4726,4746,1061,1041,4107900
3984,75566,3144,3144,2590,2609,554,535,3072.0,,2669.0,,403.0,,3029,3029,2517,2588,512,441,4120333
3985,75574,9285,9285,7842,7828,1443,1457,9054.0,,7850.0,,1204.0,,8964,8964,7854,7716,1110,1248,4108007
3986,75582,3655,3655,2886,2943,769,712,3688.0,,3064.0,,624.0,,3834,3834,3021,2911,813,923,4120655
3987,75590,2301,2301,1988,1980,313,321,2238.0,,2060.0,,178.0,,2133,2133,1866,1863,267,270,4108106
3988,75604,5383,5383,4183,4145,1200,1238,5231.0,,4448.0,,783.0,,5097,5097,4258,4167,839,930,4121752
3989,75612,6342,6342,4909,5052,1433,1290,6316.0,,5044.0,,1272.0,,6308,6308,4941,4947,1367,1361,4108205
3990,75620,3587,3587,2679,2616,908,971,3564.0,,2993.0,,571.0,,3478,3478,2509,2435,969,1043,4122172
3991,75639,196153,196153,158683,159451,37470,36702,183306.0,,141027.0,,42279.0,,178270,178270,148583,148625,29687,29645,4108304
3992,75647,4393,4393,3663,3676,730,717,4336.0,,3730.0,,606.0,,4317,4317,3552,3552,765,765,4126355
3993,75655,68622,68622,55518,55921,13104,12701,66147.0,,49557.0,,16590.0,,65206,65206,52631,52371,12575,12835,4108403
3994,75663,8372,8372,6511,6465,1861,1907,8288.0,,6573.0,,1715.0,,8102,8102,6336,6287,1766,1815,4126678
3995,75671,8626,8626,6685,6726,1941,1900,8474.0,,6762.0,,1712.0,,8427,8427,6956,6942,1471,1485,4108502
3996,75698,22618,22618,17178,17643,5440,4975,22555.0,,17257.0,,5298.0,,22098,22098,16865,16643,5233,5455,4108601
3997,75710,23543,23543,18453,18624,5090,4919,22639.0,,17338.0,,5301.0,,20863,20863,17865,17788,2998,3075,4108809
3998,75736,5146,5146,4139,4174,1007,972,5133.0,,4366.0,,767.0,,4804,4804,4039,4034,765,770,4108908
3999,75744,4960,4960,3623,3588,1337,1372,5029.0,,4049.0,,980.0,,4947,4947,3644,3630,1303,1317,4122651
4000,75752,3735,3735,3053,3034,682,701,3664.0,,3245.0,,419.0,,3468,3468,2931,2898,537,570,4109005
4001,75760,5762,5762,4680,4654,1082,1108,5631.0,,4892.0,,739.0,,5408,5408,4725,4634,683,774,4117271
4002,75779,1978,1978,1579,1595,399,383,1927.0,,1691.0,,236.0,,1917,1917,1512,1447,405,470,4109104
4003,75787,2819,2819,2390,2403,429,416,2796.0,,2498.0,,298.0,,2667,2667,2357,2347,310,320,4126652
4004,75795,4222,4222,3475,3517,747,705,4234.0,,3706.0,,528.0,,4197,4197,3646,3635,551,562,4109203
4005,75809,5763,5763,4558,4582,1205,1181,5688.0,,4734.0,,954.0,,5528,5528,4542,4506,986,1022,4113734
4006,75817,11249,11249,8848,8884,2401,2365,11080.0,,9005.0,,2075.0,,11148,11148,9029,8860,2119,2288,4109302
4007,75833,132162,132162,107222,108421,24940,23741,126989.0,,99338.0,,27651.0,,125677,125677,105124,104982,20553,20695,4109401
4008,75850,6953,6953,5425,5188,1528,1765,6635.0,,5782.0,,853.0,,6468,6468,5156,4842,1312,1626,4109500
4009,75876,28616,28616,22026,22230,6590,6386,26455.0,,20487.0,,5968.0,,23932,23932,19494,19372,4438,4560,4109609
4010,75892,21645,21645,16628,16890,5017,4755,21103.0,,15958.0,,5145.0,,20826,20826,17026,16884,3800,3942,4109708
4011,75914,39889,39889,31341,32014,8548,7875,38337.0,,29308.0,,9029.0,,37397,37397,31029,31463,6368,5934,4109807
4012,75930,7262,7262,5567,5666,1695,1596,7200.0,,5638.0,,1562.0,,7274,7274,5541,5531,1733,1743,4109906
4013,75957,3913,3913,3132,3166,781,747,3895.0,,3303.0,,592.0,,3653,3653,2934,2887,719,766,4110003
4014,75973,23288,23288,19439,19275,3849,4013,22708.0,,19021.0,,3687.0,,22323,22323,19507,19390,2816,2933,4110102
4015,75990,8154,8154,6777,6660,1377,1494,8047.0,,6995.0,,1052.0,,7905,7905,6882,6752,1023,1153,4110201
4016,76015,2350,2350,1931,1900,419,450,2306.0,,1984.0,,322.0,,2271,2271,2045,1940,226,331,4110300
4017,76031,11166,11166,9536,9630,1630,1536,10834.0,,9377.0,,1457.0,,10716,10716,9421,9413,1295,1303,4110508
4018,76058,11973,11973,9435,9457,2538,2516,11673.0,,9322.0,,2351.0,,11540,11540,9725,9517,1815,2023,4110607
4019,76074,45733,45733,37859,38237,7874,7496,44567.0,,34530.0,,10037.0,,44316,44316,38463,38152,5853,6164,4110706
4020,76090,7991,7991,6143,6205,1848,1786,7668.0,,6324.0,,1344.0,,7517,7517,6431,6286,1086,1231,4110805
4021,76112,3592,3592,2771,2804,821,788,3576.0,,2958.0,,618.0,,3602,3602,2727,2685,875,917,4110904
4022,76139,5127,5127,3861,3977,1266,1150,5060.0,,4116.0,,944.0,,4927,4927,4001,3926,926,1001,4111001
4023,76155,5214,5214,4210,4238,1004,976,5208.0,,4191.0,,1017.0,,4983,4983,4008,4009,975,974,4111100
4024,76171,9235,9235,7454,7600,1781,1635,9067.0,,7633.0,,1434.0,,9039,9039,7334,7368,1705,1671,4111209
4025,76198,3055,3055,2226,2229,829,826,3073.0,,2401.0,,672.0,,3078,3078,2184,2172,894,906,4111308
4026,76210,10273,10273,8815,8859,1458,1414,9938.0,,8716.0,,1222.0,,9984,9984,8850,8873,1134,1111,4111407
4027,76236,25536,25536,19799,19960,5737,5576,25152.0,,19393.0,,5759.0,,24637,24637,19062,18934,5575,5703,4111506
4028,76252,2796,2796,2085,2092,711,704,2754.0,,2090.0,,664.0,,2436,2436,1895,1837,541,599,4111605
4029,76279,4210,4210,3465,3547,745,663,4029.0,,3614.0,,415.0,,3910,3910,3282,3316,628,594,4111704
4030,76295,29898,29898,23659,24104,6239,5794,28976.0,,22330.0,,6646.0,,28540,28540,24216,24138,4324,4402,4111803
4031,76317,10592,10592,8295,8445,2297,2147,10260.0,,7726.0,,2534.0,,9944,9944,8238,8235,1706,1709,4111902
4032,76333,25672,25672,20787,21044,4885,4628,25031.0,,19914.0,,5117.0,,24572,24572,20948,20766,3624,3806,4112009
4033,76350,16389,16389,13549,13729,2840,2660,15807.0,,12650.0,,3157.0,,15537,15537,13457,13459,2080,2078,4112108
4034,76376,4977,4977,3843,3899,1134,1078,4950.0,,4063.0,,887.0,,4986,4986,3987,3974,999,1012,4112207
4035,76392,3728,3728,2962,3026,766,702,3607.0,,3045.0,,562.0,,3679,3679,3026,2994,653,685,4112306
4036,76414,7205,7205,5906,5998,1299,1207,7079.0,,5940.0,,1139.0,,6937,6937,5910,5948,1027,989,4112405
4037,76430,9669,9669,7386,7540,2283,2129,9643.0,,7644.0,,1999.0,,9265,9265,6983,7006,2282,2259,4112504
4038,76457,1237,1237,1057,1055,180,182,1230.0,,1134.0,,96.0,,1173,1173,1043,1037,130,136,4112603
4039,76473,9454,9454,7525,7721,1929,1733,9255.0,,7657.0,,1598.0,,9105,9105,7667,7838,1438,1267,4112702
4040,76490,9240,9240,7304,7480,1936,1760,8993.0,,7349.0,,1644.0,,8641,8641,7231,7187,1410,1454,4112801
4041,76511,2687,2687,2070,2096,617,591,2561.0,,2139.0,,422.0,,2543,2543,2098,2086,445,457,4112900
4042,76538,5512,5512,4458,4545,1054,967,5421.0,,4691.0,,730.0,,5148,5148,4394,4342,754,806,4113007
4043,76554,3812,3812,3212,3251,600,561,3761.0,,3285.0,,476.0,,3523,3523,3109,3080,414,443,4113106
4044,76570,36406,36406,30251,30463,6155,5943,35249.0,,28438.0,,6811.0,,34773,34773,29811,29838,4962,4935,4113205
4045,76597,24294,24294,19642,19637,4652,4657,23564.0,,18831.0,,4733.0,,23398,23398,19755,19677,3643,3721,4113304
4046,76619,3399,3399,2775,2816,624,583,3366.0,,2970.0,,396.0,,3172,3172,2799,2773,373,399,4113403
4047,76635,15035,15035,12380,12600,2655,2435,14413.0,,11897.0,,2516.0,,14139,14139,12437,12249,1702,1890,4113502
4048,76651,3792,3792,3158,3199,634,593,3759.0,,3312.0,,447.0,,3556,3556,3036,3006,520,550,4113601
4049,76678,393687,393687,317408,321706,76279,71981,376073.0,,278784.0,,97289.0,,372008,372008,309378,309112,62630,62896,4113700
4050,76694,3949,3949,3222,3247,727,702,3940.0,,3460.0,,480.0,,3858,3858,3275,3243,583,615,4113809
4051,76716,10672,10672,8828,8903,1844,1769,10424.0,,8753.0,,1671.0,,10245,10245,8788,8802,1457,1443,4113908
4052,76732,10834,10834,8816,8927,2018,1907,10712.0,,8886.0,,1826.0,,10547,10547,9119,9022,1428,1525,4114005
4053,76759,19487,19487,14986,15301,4501,4186,18522.0,,13608.0,,4914.0,,17789,17789,13688,13624,4101,4165,4114104
4054,76775,28100,28100,22366,22950,5734,5150,27228.0,,21532.0,,5696.0,,26660,26660,21965,22307,4695,4353,4114203
4055,76791,18929,18929,15465,15485,3464,3444,18195.0,,14937.0,,3258.0,,17727,17727,14626,14666,3101,3061,4114302
4056,76813,10619,10619,8769,8917,1850,1702,10232.0,,8895.0,,1337.0,,10014,10014,8634,8593,1380,1421,4114500
4057,76830,41355,41355,33209,33062,8146,8293,40375.0,,30433.0,,9942.0,,38861,38861,31616,31242,7245,7619,4114609
4058,76856,4727,4727,3885,3917,842,810,4636.0,,3970.0,,666.0,,4521,4521,3851,3843,670,678,4114708
4059,76872,30286,30286,23466,23984,6820,6302,29096.0,,21972.0,,7124.0,,28727,28727,22504,22671,6223,6056,4114807
4060,76899,8167,8167,6242,6403,1925,1764,8282.0,,6603.0,,1679.0,,8127,8127,6377,6311,1750,1816,4115101
4061,76910,294583,294583,235930,239474,58653,55109,279500.0,,195581.0,,83919.0,,276073,276073,222810,222326,53263,53747,4115200
4062,76937,5271,5271,4396,4460,875,811,5159.0,,4556.0,,603.0,,4958,4958,4358,4342,600,616,4115309
4063,76953,11507,11507,9518,9588,1989,1919,11186.0,,9163.0,,2023.0,,10943,10943,9475,9438,1468,1505,4115408
4064,76970,3705,3705,3210,3224,495,481,3676.0,,3273.0,,403.0,,3549,3549,3192,3122,357,427,4115507
4065,76996,13909,13909,10715,10916,3194,2993,13678.0,,10572.0,,3106.0,,13138,13138,10109,10157,3029,2981,4115606
4066,77011,38663,38663,30271,30702,8392,7961,37648.0,,28023.0,,9625.0,,35829,35829,27773,28090,8056,7739,4115804
4067,77038,2171,2171,1686,1641,485,530,2144.0,,1846.0,,298.0,,2123,2123,1595,1540,528,583,4115903
4068,77054,1756,1756,1540,1515,216,241,1757.0,,1582.0,,175.0,,1699,1699,1537,1497,162,202,4116000
4069,77070,9764,9764,7608,7737,2156,2027,9852.0,,7870.0,,1982.0,,9672,9672,7697,7605,1975,2067,4116109
4070,77097,13758,13758,10950,10958,2808,2800,13137.0,,10457.0,,2680.0,,12444,12444,10438,10289,2006,2155,4116208
4071,77119,3376,3376,2791,2806,585,570,3327.0,,2983.0,,344.0,,3202,3202,2757,2751,445,451,4116307
4072,77135,3062,3062,2538,2557,524,505,2974.0,,2651.0,,323.0,,2909,2909,2505,2476,404,433,4116406
4073,77151,1447,1447,1216,1205,231,242,1399.0,,1274.0,,125.0,,1331,1331,1160,1119,171,212,4116505
4074,77178,3099,3099,2652,2612,447,487,3017.0,,2762.0,,255.0,,2867,2867,2528,2469,339,398,4116604
4075,77194,5913,5913,4769,4758,1144,1155,5856.0,,5103.0,,753.0,,5705,5705,4727,4636,978,1069,4116802
4076,77216,21023,21023,15903,16286,5120,4737,20751.0,,14629.0,,6122.0,,21074,21074,15689,15645,5385,5429,4116901
4077,77232,6394,6394,4790,4832,1604,1562,6422.0,,4944.0,,1478.0,,6376,6376,4743,4627,1633,1749,4117008
4078,77259,10613,10613,7605,7701,3008,2912,10458.0,,7350.0,,3108.0,,10331,10331,7273,7166,3058,3165,4117107
4079,77275,19030,19030,14529,14571,4501,4459,18328.0,,14874.0,,3454.0,,17615,17615,14117,13921,3498,3694,4117305
4080,77291,2858,2858,2319,2348,539,510,2853.0,,2406.0,,447.0,,2912,2912,2368,2336,544,576,4117404
4081,77313,29023,29023,23052,23327,5971,5696,27873.0,,21110.0,,6763.0,,27555,27555,21939,22028,5616,5527,4117503
4082,77330,32197,32197,24108,24379,8089,7818,31351.0,,22642.0,,8709.0,,30407,30407,24415,24458,5992,5949,4117602
4083,77356,26604,26604,22274,22517,4330,4087,25674.0,,21014.0,,4660.0,,25227,25227,21887,21762,3340,3465,4117701
4084,77372,10882,10882,8504,8574,2378,2308,10607.0,,8744.0,,1863.0,,10399,10399,8569,8477,1830,1922,4117800
4085,77399,25015,25015,20012,20459,5003,4556,24490.0,,18535.0,,5955.0,,23803,23803,19402,19216,4401,4587,4117909
4086,77410,9969,9969,7959,8103,2010,1866,9641.0,,7759.0,,1882.0,,9327,9327,7575,7476,1752,1851,4118006
4087,77437,7879,7879,5997,6125,1882,1754,7678.0,,6119.0,,1559.0,,7495,7495,6146,6166,1349,1329,4118105
4088,77453,105103,105103,85272,85419,19831,19684,101403.0,,78809.0,,22594.0,,98933,98933,83129,83127,15804,15806,4118204
4089,77470,2084,2084,1766,1740,318,344,2045.0,,1874.0,,171.0,,1998,1998,1763,1729,235,269,4118303
4090,77496,64053,64053,50967,51826,13086,12227,61661.0,,46026.0,,15635.0,,60172,60172,50547,50514,9625,9658,4118402
4091,77518,65320,65320,51974,52535,13346,12785,62391.0,,46877.0,,15514.0,,61406,61406,49522,49239,11884,12167,4118501
4092,77534,4513,4513,3730,3787,783,726,4409.0,,3869.0,,540.0,,4264,4264,3663,3691,601,573,4118600
4093,77550,5532,5532,4718,4759,814,773,5439.0,,4812.0,,627.0,,5400,5400,4767,4775,633,625,4118709
4094,77577,10579,10579,8147,8284,2432,2295,10543.0,,7999.0,,2544.0,,10473,10473,7920,7906,2553,2567,4118808
4095,77593,5388,5388,4385,4466,1003,922,5381.0,,4674.0,,707.0,,5266,5266,4341,4286,925,980,4119004
4096,77615,10003,10003,8758,8802,1245,1201,9732.0,,8776.0,,956.0,,9238,9238,8347,8333,891,905,4119103
4097,77631,5502,5502,4456,4517,1046,985,5284.0,,4591.0,,693.0,,5101,5101,4332,4328,769,773,4119202
4098,77658,23787,23787,18150,18341,5637,5446,23289.0,,18406.0,,4883.0,,22593,22593,18602,18622,3991,3971,4119301
4099,77674,18840,18840,15174,15353,3666,3487,18407.0,,14836.0,,3571.0,,18348,18348,15486,15383,2862,2965,4119400
4100,77690,69483,69483,55258,55543,14225,13940,65044.0,,48728.0,,16316.0,,62695,62695,51320,51157,11375,11538,4119509
4101,77712,27181,27181,20948,21009,6233,6172,26983.0,,20899.0,,6084.0,,26446,26446,20125,20052,6321,6394,4119608
4102,77739,3207,3207,2697,2725,510,482,3188.0,,2852.0,,336.0,,3151,3151,2718,2723,433,428,4119707
4103,77755,10688,10688,8529,8602,2159,2086,10637.0,,8671.0,,1966.0,,10609,10609,8183,8211,2426,2398,4119806
4104,77771,251970,251970,206465,208491,45505,43479,239611.0,239611.0,184464.0,179956.0,55147.0,59655.0,237118,237118,202508,201102,34610,36016,4119905
4105,77798,9822,9822,7673,7800,2149,2022,9745.0,,7792.0,,1953.0,,9687,9687,8061,7965,1626,1722,4120002
4106,77810,3780,3780,3095,3081,685,699,3751.0,,3295.0,,456.0,,3517,3517,3012,2971,505,546,4120101
4107,77836,2563,2563,2160,2160,403,403,2509.0,,2185.0,,324.0,,2152,2152,1911,1843,241,309,4120200
4108,77852,3154,3154,2552,2594,602,560,3007.0,,2598.0,,409.0,,2920,2920,2483,2484,437,436,4120309
4109,77879,4028,4028,3159,3196,869,832,4035.0,,3334.0,,701.0,,4013,4013,3154,3138,859,875,4120408
4110,77895,8779,8779,7074,7227,1705,1552,8726.0,,7283.0,,1443.0,,8652,8652,6924,6909,1728,1743,4120507
4111,77917,38777,38777,31717,32152,7060,6625,37979.0,,30977.0,,7002.0,,37582,37582,31659,31931,5923,5651,4120606
4112,77933,6669,6669,5382,5522,1287,1147,6469.0,,5507.0,,962.0,,6243,6243,5300,5291,943,952,4120705
4113,77950,16722,16722,13874,14002,2848,2720,15802.0,,12764.0,,3038.0,,15011,15011,12762,12690,2249,2321,4120804
4114,77976,7859,7859,6552,6600,1307,1259,7545.0,,6359.0,,1186.0,,7569,7569,6679,6592,890,977,4121000
4115,77992,4367,4367,3423,3444,944,923,4313.0,,3555.0,,758.0,,4416,4416,3359,3290,1057,1126,4121109
4116,78018,13482,13482,11489,11608,1993,1874,13148.0,,11540.0,,1608.0,,12810,12810,11304,11307,1506,1503,4121208
4117,78034,3130,3130,2534,2634,596,496,3013.0,,2661.0,,352.0,,2985,2985,2637,2560,348,425,4121307
4118,78050,14810,14810,11599,11800,3211,3010,14418.0,,11602.0,,2816.0,,13898,13898,10933,10883,2965,3015,4121406
4119,78077,11922,11922,10111,10088,1811,1834,11515.0,,9734.0,,1781.0,,11259,11259,9843,9819,1416,1440,4121505
4120,78093,5263,5263,4387,4419,876,844,5014.0,,4287.0,,727.0,,4936,4936,4367,4338,569,598,4121604
4121,78115,20517,20517,15682,16008,4835,4509,20178.0,,15715.0,,4463.0,,19706,19706,15814,15982,3892,3724,4121703
4122,78131,9790,9790,7478,7711,2312,2079,9603.0,,7473.0,,2130.0,,9455,9455,7597,7702,1858,1753,4121802
4123,78158,10444,10444,7982,8007,2462,2437,10306.0,,7900.0,,2406.0,,10268,10268,8342,8226,1926,2042,4121901
4124,78174,10891,10891,9494,9543,1397,1348,10522.0,,9412.0,,1110.0,,10420,10420,9484,9394,936,1026,4122008
4125,78190,2975,2975,2419,2436,556,539,2925.0,,2503.0,,422.0,,2849,2849,2391,2382,458,467,4122107
4126,78212,26389,26389,22004,22246,4385,4143,25506.0,,21936.0,,3570.0,,24987,24987,21017,20988,3970,3999,4122206
4127,78239,23918,23918,19405,19816,4513,4102,23157.0,,18046.0,,5111.0,,22703,22703,19520,19616,3183,3087,4122305
4128,78255,49289,49289,39183,39856,10106,9433,47832.0,,35416.0,,12416.0,,46562,46562,39461,39468,7101,7094,4122404
4129,78271,8687,8687,7005,7076,1682,1611,8311.0,,7106.0,,1205.0,,8140,8140,7215,7031,925,1109,4122503
4130,78298,7425,7425,5877,5942,1548,1483,7343.0,,5886.0,,1457.0,,7314,7314,5918,5846,1396,1468,4122602
4131,78310,6064,6064,5079,5212,985,852,5881.0,,5064.0,,817.0,,5364,5364,4708,4783,656,581,4122701
4132,78336,3565,3565,2996,3037,569,528,3579.0,,3145.0,,434.0,,3427,3427,3014,2982,413,445,4122800
4133,78352,4292,4292,3452,3476,840,816,4280.0,,3660.0,,620.0,,4014,4014,3326,3307,688,707,4122909
4134,78379,11175,11175,9179,9187,1996,1988,10822.0,,9387.0,,1435.0,,10413,10413,8997,8961,1416,1452,4123006
4135,78395,3043,3043,2439,2409,604,634,3026.0,,2630.0,,396.0,,2897,2897,2526,2493,371,404,4123105
4136,78417,3072,3072,2470,2447,602,625,3001.0,,2625.0,,376.0,,2946,2946,2527,2440,419,506,4123204
4137,78433,6430,6430,5387,5430,1043,1000,6257.0,,5256.0,,1001.0,,6181,6181,5397,5385,784,796,4123303
4138,78450,8954,8954,7199,7383,1755,1571,8679.0,,7090.0,,1589.0,,8519,8519,7179,7213,1340,1306,4123402
4139,78476,1707,1707,1434,1434,273,273,1701.0,,1523.0,,178.0,,1693,1693,1380,1334,313,359,4123600
4140,78492,6925,6925,5551,5599,1374,1326,6812.0,,5502.0,,1310.0,,6667,6667,5647,5640,1020,1027,4123709
4141,78514,9199,9199,7427,7581,1772,1618,9155.0,,7708.0,,1447.0,,8741,8741,6987,6972,1754,1769,4123808
4142,78530,9482,9482,7283,7404,2199,2078,9493.0,,7540.0,,1953.0,,9441,9441,7518,7568,1923,1873,4123907
4143,78557,4480,4480,3568,3660,912,820,4387.0,,3543.0,,844.0,,4238,4238,3573,3563,665,675,4124004
4144,78573,14992,14992,12402,12365,2590,2627,14333.0,,12193.0,,2140.0,,13970,13970,12193,12152,1777,1818,4124400
4145,78590,32661,32661,25784,26204,6877,6457,31621.0,,24194.0,,7427.0,,31051,31051,26094,26038,4957,5013,4124103
4146,78611,2342,2342,1858,1940,484,402,2377.0,,2073.0,,304.0,,2354,2354,1890,1838,464,516,4124202
4147,78638,2119,2119,1781,1772,338,347,2112.0,,1918.0,,194.0,,2026,2026,1783,1716,243,310,4124301
4148,78654,4555,4555,3830,3805,725,750,4445.0,,3969.0,,476.0,,4241,4241,3706,3691,535,550,4124509
4149,78670,5374,5374,4355,4434,1019,940,5359.0,,4554.0,,805.0,,5171,5171,4158,4087,1013,1084,4124608
4150,78697,8446,8446,6447,6425,1999,2021,8239.0,,6519.0,,1720.0,,8129,8129,6453,6419,1676,1710,4124707
4151,78719,8986,8986,7496,7595,1490,1391,8888.0,,7667.0,,1221.0,,8725,8725,7537,7497,1188,1228,4124806
4152,78735,4854,4854,3779,3825,1075,1029,4864.0,,3953.0,,911.0,,4773,4773,3647,3610,1126,1163,4124905
4153,78751,9045,9045,6980,7159,2065,1886,8865.0,,7176.0,,1689.0,,8799,8799,7409,7407,1390,1392,4125001
4154,78778,11253,11253,9537,9624,1716,1629,10867.0,,9450.0,,1417.0,,10811,10811,9379,9400,1432,1411,4125100
4155,78794,4797,4797,3844,3932,953,865,4741.0,,4021.0,,720.0,,4727,4727,3792,3787,935,940,4125308
4156,78816,7867,7867,6778,6794,1089,1073,7667.0,,6898.0,,769.0,,7466,7466,6614,6553,852,913,4125209
4157,78832,4625,4625,3731,3761,894,864,4628.0,,4082.0,,546.0,,4447,4447,3718,3761,729,686,4125407
4158,78859,211775,211775,172121,173818,39654,37957,197064.0,,147294.0,,49770.0,,188531,188531,159831,158883,28700,29648,4125506
4159,78875,33777,33777,27969,28210,5808,5567,32369.0,,26439.0,,5930.0,,31924,31924,27477,27477,4447,4447,4125605
4160,78891,22767,22767,17735,17917,5032,4850,22345.0,,17086.0,,5259.0,,21972,21972,16580,16721,5392,5251,4125704
4161,78913,6997,6997,5578,5655,1419,1342,6881.0,,5569.0,,1312.0,,6875,6875,6019,5944,856,931,4125803
4162,78930,2424,2424,2024,2026,400,398,2422.0,,2161.0,,261.0,,2179,2179,1944,1884,235,295,4125902
4163,78956,6743,6743,5365,5397,1378,1346,6609.0,,5456.0,,1153.0,,6549,6549,5555,5524,994,1025,4126009
4164,78972,4599,4599,3772,3766,827,833,4584.0,,3985.0,,599.0,,4356,4356,3765,3711,591,645,4126108
4165,78999,5374,5374,4168,4258,1206,1116,5222.0,,4409.0,,813.0,,5014,5014,4150,4127,864,887,4126207
4166,79014,13643,13643,10755,10860,2888,2783,13528.0,,10594.0,,2934.0,,13548,13548,11160,11042,2388,2506,4126306
4167,79030,4782,4782,3965,4045,817,737,4682.0,,3991.0,,691.0,,4575,4575,3975,3940,600,635,4126405
4168,79057,13116,13116,10639,10849,2477,2267,12821.0,,10348.0,,2473.0,,12661,12661,10478,10600,2183,2061,4126504
4169,79073,15995,15995,12532,12744,3463,3251,15487.0,,11853.0,,3634.0,,15085,15085,12257,12522,2828,2563,4126603
4170,79090,4087,4087,3289,3349,798,738,4061.0,,3440.0,,621.0,,3924,3924,3341,3270,583,654,4126702
4171,79111,12377,12377,9425,9671,2952,2706,12362.0,,9902.0,,2460.0,,11744,11744,9246,9154,2498,2590,4126801
4172,79138,7852,7852,6486,6502,1366,1350,7646.0,,6559.0,,1087.0,,7486,7486,6334,6283,1152,1203,4127007
4173,79154,50816,50816,42098,42234,8718,8582,48593.0,,39281.0,,9312.0,,46780,46780,41408,41117,5372,5663,4127106
4174,79170,13315,13315,10668,10849,2647,2466,12855.0,,10416.0,,2439.0,,12410,12410,10417,10426,1993,1984,4127205
4175,79197,11961,11961,9224,9371,2737,2590,11704.0,,8862.0,,2842.0,,11635,11635,9626,9580,2009,2055,4127304
4176,79219,13455,13455,10890,11146,2565,2309,12962.0,,10459.0,,2503.0,,12678,12678,10879,10932,1799,1746,4127403
4177,79235,14531,14531,11523,11624,3008,2907,14142.0,,11277.0,,2865.0,,13790,13790,11737,11496,2053,2294,4127502
4178,79251,11975,11975,9889,9992,2086,1983,11568.0,,9677.0,,1891.0,,11161,11161,9340,9371,1821,1790,4127601
4179,79278,104165,104165,85377,86931,18788,17234,98692.0,,76657.0,,22035.0,,96136,96136,81405,81068,14731,15068,4127700
4180,79294,6486,6486,5197,5253,1289,1233,6348.0,,5348.0,,1000.0,,6216,6216,5177,5163,1039,1053,4127809
4181,79316,6930,6930,5242,5485,1688,1445,6872.0,,5812.0,,1060.0,,6930,6930,5402,5432,1528,1498,4127908
4182,79332,19561,19561,15252,15527,4309,4034,19436.0,,15545.0,,3891.0,,18611,18611,14876,14663,3735,3948,4128005
4183,79359,81501,81501,64351,65774,17150,15727,78446.0,,53836.0,,24610.0,,76375,76375,64510,64344,11865,12031,4128104
4184,79375,40445,40445,31944,32398,8501,8047,38848.0,,28946.0,,9902.0,,37577,37577,31834,31741,5743,5836,4128203
4185,79391,2129,2129,1792,1793,337,336,2114.0,,1962.0,,152.0,,2106,2106,1758,1725,348,381,4128302
4186,79413,8597,8597,7041,7098,1556,1499,8383.0,,6902.0,,1481.0,,8285,8285,7155,7016,1130,1269,4128401
4187,79430,14687,14687,11347,11516,3340,3171,14486.0,,11185.0,,3301.0,,14210,14210,11674,11624,2536,2586,4128500
4188,79456,7026,7026,5951,6001,1075,1025,7061.0,,6397.0,,664.0,,6683,6683,5619,5624,1064,1059,4128609
4189,79472,5727,5727,4500,4645,1227,1082,5547.0,,4449.0,,1098.0,,5476,5476,4291,4258,1185,1218,4128708
4190,79499,5219,5219,4232,4282,987,937,5188.0,,4505.0,,683.0,,5004,5004,4392,4290,612,714,4128807
4191,79510,14811,14811,11537,11809,3274,3002,14551.0,,11297.0,,3254.0,,14472,14472,12271,12256,2201,2216,4100509
4192,79537,27824,27824,21823,22349,6001,5475,26999.0,,20696.0,,6303.0,,26384,26384,20919,20790,5465,5594,4102000
4193,79553,24640,24640,18480,18437,6160,6203,24302.0,,18791.0,,5511.0,,23377,23377,17431,17211,5946,6166,4120903
4194,79570,9017,9017,7194,7347,1823,1670,8985.0,,7240.0,,1745.0,,8861,8861,7084,7056,1777,1805,4105300
4195,79596,5221,5221,3854,3854,1367,1367,5184.0,,4111.0,,1073.0,,5190,5190,3832,3756,1358,1434,4108700
4196,79618,3825,3825,3068,3113,757,712,3746.0,,3039.0,,707.0,,3624,3624,3088,3083,536,541,4110409
4197,79634,32260,32260,23421,23540,8839,8720,28902.0,,20137.0,,8765.0,,26390,26390,20535,20345,5855,6045,4115705
4198,79650,10127,10127,8263,8400,1864,1727,10086.0,,8489.0,,1597.0,,9653,9653,7897,7773,1756,1880,4116703
4199,79677,4896,4896,3930,3986,966,910,4882.0,,4100.0,,782.0,,4830,4830,3899,3850,931,980,4117206
4200,79693,9340,9340,7261,7430,2079,1910,9223.0,,7133.0,,2090.0,,9023,9023,7479,7456,1544,1567,4118907
4201,79715,21296,21296,17152,17138,4144,4158,20967.0,,17253.0,,3714.0,,20440,20440,16110,16068,4330,4372,4123501
4202,79731,4742,4742,3752,3758,990,984,4775.0,,4015.0,,760.0,,4706,4706,3720,3695,986,1011,4126900
4203,79758,6159,6159,4588,4674,1571,1485,6069.0,,4700.0,,1369.0,,6030,6030,4420,4400,1610,1630,4115002
4204,79774,6057,6057,4695,4759,1362,1298,5865.0,,4788.0,,1077.0,,5531,5531,4668,4659,863,872,4108320
4205,79790,6909,6909,5938,5994,971,915,6903.0,,5896.0,,1007.0,,6621,6621,5705,5618,916,1003,4117222
4206,79812,7009,7009,5436,5481,1573,1528,7031.0,,5931.0,,1100.0,,6858,6858,5208,5109,1650,1749,4103057
4207,79839,4615,4615,3621,3685,994,930,4687.0,,3966.0,,721.0,,4668,4668,3663,3609,1005,1059,4103354
4208,79855,13293,13293,10755,10942,2538,2351,13103.0,,10719.0,,2384.0,,11968,11968,9890,9851,2078,2117,4103453
4209,79871,9187,9187,7500,7474,1687,1713,9268.0,,7839.0,,1429.0,,9126,9126,7304,7238,1822,1888,4127858
4210,79898,6933,6933,5396,5485,1537,1448,7006.0,,5800.0,,1206.0,,6965,6965,5466,5376,1499,1589,4128559
4211,79910,4628,4628,3908,3949,720,679,4557.0,,3967.0,,590.0,,4498,4498,3996,3981,502,517,4120358
4212,79936,5993,5993,5162,5204,831,789,5787.0,,5146.0,,641.0,,5546,5546,5092,5052,454,494,4127957
4213,79952,8618,8618,7140,7144,1478,1474,8374.0,,7213.0,,1161.0,,8075,8075,7095,6938,980,1137,4117255
4214,79979,7533,7533,6003,6118,1530,1415,7550.0,,6232.0,,1318.0,,7251,7251,5925,5867,1326,1384,4112751
4215,79995,5142,5142,4139,4212,1003,930,5080.0,,4434.0,,646.0,,4998,4998,4272,4298,726,700,4125357
4216,80004,7162,7162,5615,5744,1547,1418,7173.0,,5961.0,,1212.0,,7326,7326,5729,5674,1597,1652,4211058
4217,80012,12816,12816,9716,9835,3100,2981,12619.0,,10032.0,,2587.0,,13083,13083,9745,9732,3338,3351,4200101
4218,80020,7285,7285,6206,6279,1079,1006,7130.0,,6173.0,,957.0,,7043,7043,5998,5962,1045,1081,4207650
4219,80039,8007,8007,6795,6950,1212,1057,7880.0,,6707.0,,1173.0,,7829,7829,6638,6608,1191,1221,4200200
4220,80047,3650,3650,3010,3051,640,599,3635.0,,3191.0,,444.0,,3677,3677,3066,3025,611,652,4209854
4221,80055,4351,4351,3740,3837,611,514,4342.0,,3844.0,,498.0,,4158,4158,3597,3584,561,574,4200309
4222,80063,8202,8202,6694,6779,1508,1423,8047.0,,6668.0,,1379.0,,8079,8079,6711,6579,1368,1500,4201257
4223,80071,5459,5459,4444,4530,1015,929,5367.0,,4484.0,,883.0,,5448,5448,4312,4323,1136,1125,4200408
4224,80080,3009,3009,2493,2523,516,486,2964.0,,2563.0,,401.0,,2961,2961,2489,2457,472,504,4205159
4225,80098,4761,4761,3895,3997,866,764,4715.0,,4085.0,,630.0,,4776,4776,3883,3885,893,891,4200507
4226,80101,4295,4295,3511,3597,784,698,4193.0,,3756.0,,437.0,,4090,4090,3304,3258,786,832,4209151
4227,80110,6054,6054,5307,5331,747,723,5769.0,,4989.0,,780.0,,5693,5693,5128,5089,565,604,4200606
4228,80128,4472,4472,3645,3693,827,779,4496.0,,3930.0,,566.0,,4346,4346,3426,3387,920,959,4219358
4229,80136,7661,7661,6724,6755,937,906,7171.0,,6582.0,,589.0,,7143,7143,6592,6528,551,615,4200705
4230,80144,2470,2470,2127,2132,343,338,2469.0,,2311.0,,158.0,,2512,2512,2125,2103,387,409,4218855
4231,80152,4966,4966,4215,4269,751,697,4902.0,,4358.0,,544.0,,4697,4697,4057,4085,640,612,4200804
4232,80160,2362,2362,1986,1992,376,370,2303.0,,2014.0,,289.0,,2286,2286,1885,1840,401,446,4218954
4233,80179,4995,4995,4408,4421,587,574,4871.0,,4455.0,,416.0,,4849,4849,4391,4328,458,521,4200903
4234,80187,3674,3674,3117,3139,557,535,3657.0,,3346.0,,311.0,,3633,3633,3040,3041,593,592,4207759
4235,80195,7476,7476,5786,5825,1690,1651,7407.0,,5892.0,,1515.0,,7555,7555,5521,5579,2034,1976,4201000
4236,80209,5733,5733,4416,4396,1317,1337,5701.0,,4751.0,,950.0,,5602,5602,4204,4257,1398,1345,4218251
4237,80217,3147,3147,2720,2684,427,463,3007.0,,2751.0,,256.0,,2934,2934,2539,2488,395,446,4201109
4238,80225,2506,2506,2137,2177,369,329,2423.0,,2275.0,,148.0,,2325,2325,1979,1956,346,369,4200051
4239,80233,8345,8345,7306,7429,1039,916,7926.0,,6953.0,,973.0,,7610,7610,6906,6850,704,760,4201208
4240,80241,7430,7430,6148,6211,1282,1219,7188.0,,6132.0,,1056.0,,7127,7127,5896,5805,1231,1322,4215653
4241,80250,23917,23917,18550,18845,5367,5072,22620.0,,17856.0,,4764.0,,19760,19760,15268,15157,4492,4603,4201307
4242,80268,2584,2584,2185,2195,399,389,2518.0,,2374.0,,144.0,,2453,2453,2058,2039,395,414,4204152
4243,80276,52898,52898,42010,42463,10888,10435,50581.0,,38446.0,,12135.0,,49891,49891,40138,39568,9753,10323,4201406
4244,80284,2815,2815,2445,2474,370,341,2770.0,,2537.0,,233.0,,2761,2761,2370,2330,391,431,4217550
4245,80292,6543,6543,5614,5676,929,867,6418.0,,5739.0,,679.0,,6350,6350,5468,5429,882,921,4201505
4246,80306,14344,14344,11457,11667,2887,2677,13806.0,,11261.0,,2545.0,,13765,13765,11266,11281,2499,2484,4204251
4247,80314,3177,3177,2675,2712,502,465,3209.0,,2832.0,,377.0,,3094,3094,2619,2572,475,522,4201604
4248,80322,3942,3942,3430,3459,512,483,3972.0,,3644.0,,328.0,,3942,3942,3390,3349,552,593,4211454
4249,80330,6354,6354,5155,5239,1199,1115,6152.0,,4989.0,,1163.0,,6275,6275,5182,5139,1093,1136,4201703
4250,80349,6573,6573,5486,5558,1087,1015,6464.0,,5746.0,,718.0,,6522,6522,5374,5411,1148,1111,4215679
4251,80357,2900,2900,2515,2524,385,376,2899.0,,2615.0,,284.0,,2872,2872,2470,2456,402,416,4201802
4252,80365,2321,2321,1961,1981,360,340,2327.0,,2124.0,,203.0,,2355,2355,1973,1961,382,394,4210852
4253,80373,5112,5112,4448,4525,664,587,5061.0,,4604.0,,457.0,,4836,4836,4263,4292,573,544,4201901
4254,80381,3215,3215,2633,2649,582,566,3219.0,,2900.0,,319.0,,3098,3098,2476,2480,622,618,4204178
4255,80390,101641,101641,80124,81533,21517,20108,90447.0,,61682.0,,28765.0,,82758,82758,71494,70600,11264,12158,4202008
4256,80403,7281,7281,5824,5872,1457,1409,6349.0,,5146.0,,1203.0,,6021,6021,4766,4759,1255,1262,4212254
4257,80411,26993,26993,19830,20486,7163,6507,24760.0,,17814.0,,6946.0,,23015,23015,17368,17254,5647,5761,4202107
4258,80420,3087,3087,2722,2777,365,310,2958.0,,2735.0,,223.0,,2846,2846,2644,2618,202,228,4202859
4259,80438,8245,8245,6814,6919,1431,1326,8201.0,,6885.0,,1316.0,,8226,8226,6916,6888,1310,1338,4202206
4260,80446,2426,2426,2146,2140,280,286,2406.0,,2252.0,,154.0,,2372,2372,2093,2063,279,309,4217758
4261,80454,53041,53041,43129,43451,9912,9590,49720.0,,37419.0,,12301.0,,48470,48470,41315,41085,7155,7385,4202305
4262,80462,2577,2577,2040,2068,537,509,2601.0,,2366.0,,235.0,,2666,2666,2060,1970,606,696,4219150
4263,80470,261742,261742,216043,218684,45699,43058,247014.0,247014.0,180141.0,170333.0,66873.0,76681.0,243881,243881,211925,210077,31956,33804,4202404
4264,80489,3841,3841,3206,3245,635,596,3817.0,,3431.0,,386.0,,3759,3759,3178,3159,581,600,4201273
4265,80497,6513,6513,5372,5336,1141,1177,6271.0,,5250.0,,1021.0,,6001,6001,5260,5165,741,836,4202602
4266,80500,2495,2495,2183,2221,312,274,2474.0,,2290.0,,184.0,,2342,2342,2061,2055,281,287,4200556
4267,80519,4316,4316,3830,3865,486,451,4188.0,,3860.0,,328.0,,4102,4102,3807,3801,295,301,4202701
4268,80527,5847,5847,4988,5035,859,812,5649.0,,5063.0,,586.0,,5313,5313,4506,4537,807,776,4206652
4269,80535,24805,24805,20559,20953,4246,3852,24086.0,,19893.0,,4193.0,,23692,23692,19959,19796,3733,3896,4202800
4270,80543,2761,2761,2373,2397,388,364,2767.0,,2583.0,,184.0,,2793,2793,2341,2327,452,466,4213153
4271,80551,94898,94898,79759,81424,15139,13474,87640.0,,69277.0,,18363.0,,81374,81374,74085,73678,7289,7696,4202909
4272,80560,4088,4088,3360,3427,728,661,4076.0,,3670.0,,406.0,,3999,3999,3308,3243,691,756,4215075
4273,80578,53740,53740,41745,42245,11995,11495,52510.0,,38374.0,,14136.0,,52260,52260,40928,40729,11332,11531,4203006
4274,80586,1472,1472,1311,1311,161,161,1397.0,,1344.0,,53.0,,1303,1303,1188,1184,115,119,4209458
4275,80594,4929,4929,4133,4222,796,707,4865.0,,4277.0,,588.0,,4892,4892,4031,4025,861,867,4203105
4276,80608,2309,2309,1897,1916,412,393,2290.0,,2083.0,,207.0,,2330,2330,1857,1822,473,508,4215059
4277,80616,56981,56981,44834,45810,12147,11171,51322.0,,37419.0,,13903.0,,47674,47674,41438,41233,6236,6441,4203204
4278,80624,3328,3328,2719,2768,609,560,3213.0,,2966.0,,247.0,,3179,3179,2737,2704,442,475,4212270
4279,80632,9801,9801,7988,8169,1813,1632,9588.0,,7833.0,,1755.0,,9388,9388,7704,7732,1684,1656,4203303
4280,80640,5127,5127,4390,4444,737,683,5099.0,,4459.0,,640.0,,5151,5151,4408,4375,743,776,4216255
4281,80659,5983,5983,4889,4943,1094,1040,5913.0,,5048.0,,865.0,,5955,5955,4837,4817,1118,1138,4203402
4282,80667,3204,3204,2440,2355,764,849,3158.0,,2742.0,,416.0,,3180,3180,2292,2180,888,1000,4203154
4283,80675,7239,7239,5817,5866,1422,1373,7096.0,,6058.0,,1038.0,,6609,6609,5750,5634,859,975,4203501
4284,80683,10852,10852,8110,8303,2742,2549,10403.0,,8095.0,,2308.0,,9528,9528,7175,7085,2353,2443,4202057
4285,80691,26706,26706,20980,21350,5726,5356,25943.0,,20212.0,,5731.0,,25970,25970,20473,20371,5497,5599,4203600
4286,80705,3719,3719,2954,3045,765,674,3709.0,,3202.0,,507.0,,3723,3723,2919,2934,804,789,4212239
4287,80713,9206,9206,7545,7699,1661,1507,9051.0,,7667.0,,1384.0,,8830,8830,7146,7067,1684,1763,4203709
4288,80721,2264,2264,1968,1964,296,300,2275.0,,2103.0,,172.0,,2240,2240,1912,1853,328,387,4215554
4289,80730,42924,42924,33848,34732,9076,8192,41885.0,,32623.0,,9262.0,,42105,42105,33488,33529,8617,8576,4203808
4290,80748,2404,2404,1985,1986,419,418,2414.0,,2183.0,,231.0,,2433,2433,1969,1949,464,484,4202156
4291,80756,17209,17209,14154,14406,3055,2803,16855.0,,13703.0,,3152.0,,16796,16796,14029,13899,2767,2897,4203907
4292,80764,2469,2469,2161,2153,308,316,2407.0,,2271.0,,136.0,,2183,2183,1948,1919,235,264,4211652
4293,80772,8215,8215,6833,6970,1382,1245,8154.0,,7067.0,,1087.0,,7538,7538,6319,6302,1219,1236,4204004
4294,80780,1716,1716,1421,1435,295,281,1695.0,,1583.0,,112.0,,1655,1655,1347,1346,308,309,4217154
4295,80799,4370,4370,3720,3757,650,613,4402.0,,4022.0,,380.0,,4339,4339,3640,3617,699,722,4204103
4296,80802,2450,2450,2125,2142,325,308,2447.0,,2277.0,,170.0,,2279,2279,1972,1935,307,344,4201653
4297,80810,159323,159323,130962,132655,28361,26668,151220.0,,114655.0,,36565.0,,146830,146830,121420,121181,25410,25649,4204202
4298,80829,5574,5574,4586,4599,988,975,5429.0,,4881.0,,548.0,,5054,5054,4097,4142,957,912,4207684
4299,80837,59654,59654,48827,49617,10827,10037,58189.0,,46276.0,,11913.0,,57415,57415,47236,47100,10179,10315,4204301
4300,80845,2014,2014,1660,1680,354,334,1985.0,,1774.0,,211.0,,2040,2040,1619,1589,421,451,4211850
4301,80853,8163,8163,6911,7026,1252,1137,8112.0,,7070.0,,1042.0,,8095,8095,6856,6827,1239,1268,4204400
4302,80861,2047,2047,1742,1749,305,298,2045.0,,1918.0,,127.0,,1943,1943,1623,1599,320,344,4207858
4303,80870,11468,11468,9993,10084,1475,1384,11032.0,,9542.0,,1490.0,,10891,10891,9962,9956,929,935,4204509
4304,80888,2406,2406,2018,2060,388,346,2379.0,,2268.0,,111.0,,2299,2299,1948,1952,351,347,4205431
4305,80896,152206,152206,121420,122404,30786,29802,146371.0,,106563.0,,39808.0,,145486,145486,118234,116893,27252,28593,4204608
4306,80900,1774,1774,1488,1476,286,298,1771.0,,1638.0,,133.0,,1803,1803,1421,1420,382,383,4210050
4307,80918,8548,8548,7556,7587,992,961,8350.0,,7605.0,,745.0,,8191,8191,7497,7429,694,762,4204707
4308,80926,2619,2619,2021,2076,598,543,2616.0,,2150.0,,466.0,,2677,2677,2051,2044,626,633,4213351
4309,80934,31501,31501,24103,24563,7398,6938,30843.0,,22768.0,,8075.0,,30695,30695,23323,23271,7372,7424,4204806
4310,80942,3475,3475,2692,2665,783,810,3471.0,,2878.0,,593.0,,3497,3497,2672,2626,825,871,4216057
4311,80950,7026,7026,5943,6034,1083,992,6940.0,,6106.0,,834.0,,6957,6957,5861,5842,1096,1115,4204905
4312,80969,4059,4059,3318,3388,741,671,4088.0,,3619.0,,469.0,,4118,4118,3300,3292,818,826,4219176
4313,80977,11669,11669,8733,8756,2936,2913,11558.0,,8613.0,,2945.0,,11828,11828,8716,8601,3112,3227,4205001
4314,80985,16923,16923,13552,13578,3371,3345,14930.0,,11435.0,,3495.0,,13971,13971,11259,10987,2712,2984,4202453
4315,80993,3223,3223,2700,2753,523,470,3165.0,,2809.0,,356.0,,3117,3117,2595,2586,522,531,4205100
4316,81000,8446,8446,6966,7126,1480,1320,8255.0,,7098.0,,1157.0,,8326,8326,6894,6829,1432,1497,4215455
4317,81019,3964,3964,3286,3333,678,631,3980.0,,3471.0,,509.0,,3863,3863,3246,3259,617,604,4205209
4318,81027,17746,17746,14496,14656,3250,3090,17331.0,,13435.0,,3896.0,,17100,17100,14071,13973,3029,3127,4203956
4319,81035,8872,8872,7444,7468,1428,1404,8725.0,,7454.0,,1271.0,,8539,8539,7087,7085,1452,1454,4205308
4320,81043,4017,4017,3437,3471,580,546,3954.0,,3548.0,,406.0,,3869,3869,3310,3302,559,567,4204350
4321,81051,399606,399606,327747,327491,71859,72115,357049.0,,254738.0,,102311.0,,343645,343645,288046,285496,55599,58149,4205407
4322,81060,20798,20798,17504,17450,3294,3348,19694.0,,16698.0,,2996.0,,19133,19133,16375,16108,2758,3025,4205456
4323,81078,27947,27947,21547,21984,6400,5963,27750.0,,21258.0,,6492.0,,28145,28145,22114,22066,6031,6079,4205506
4324,81086,2787,2787,2306,2354,481,433,2767.0,,2393.0,,374.0,,2966,2966,2538,2472,428,494,4211256
4325,81094,2713,2713,2314,2307,399,406,2674.0,,2428.0,,246.0,,2601,2601,2325,2330,276,271,4205605
4326,81108,1972,1972,1718,1714,254,258,1985.0,,1887.0,,98.0,,1862,1862,1683,1686,179,176,4204459
4327,81116,14682,14682,12318,12486,2364,2196,14099.0,,12113.0,,1986.0,,13442,13442,11599,11537,1843,1905,4206009
4328,81124,3745,3745,3079,3137,666,608,3657.0,,3173.0,,484.0,,3544,3544,2864,2836,680,708,4216354
4329,81132,21287,21287,17472,17531,3815,3756,19023.0,,14740.0,,4283.0,,17895,17895,14653,14396,3242,3499,4205704
4330,81140,1606,1606,1445,1440,161,166,1598.0,,1521.0,,77.0,,1566,1566,1371,1356,195,210,4208955
4331,81159,11754,11754,9685,9874,2069,1880,10792.0,,8890.0,,1902.0,,10278,10278,9075,8952,1203,1326,4205803
4332,81167,2210,2210,1972,1980,238,230,2125.0,,2038.0,,87.0,,1916,1916,1795,1762,121,154,4205191
4333,81175,49386,49386,40016,40707,9370,8679,47438.0,,34959.0,,12479.0,,46254,46254,38594,38405,7660,7849,4205902
4334,81183,4143,4143,3596,3603,547,540,3880.0,,3361.0,,519.0,,3823,3823,3392,3345,431,478,4217253
4335,81191,5609,5609,4840,4919,769,690,5636.0,,5183.0,,453.0,,5633,5633,4902,4793,731,840,4206108
4336,81205,1442,1442,1260,1275,182,167,1440.0,,1381.0,,59.0,,1384,1384,1252,1254,132,130,4215687
4337,81213,9002,9002,7548,7609,1454,1393,8826.0,,7354.0,,1472.0,,8751,8751,7376,7291,1375,1460,4206207
4338,81221,5118,5118,4259,4328,859,790,5079.0,,4563.0,,516.0,,4921,4921,4062,4118,859,803,4202131
4339,81230,16027,16027,14126,14327,1901,1700,15127.0,,13306.0,,1821.0,,14489,14489,13572,13515,917,974,4206306
4340,81248,2928,2928,2380,2368,548,560,2897.0,,2480.0,,417.0,,2907,2907,2308,2279,599,628,4203253
4341,81256,9049,9049,7628,7696,1421,1353,8931.0,,7785.0,,1146.0,,8865,8865,7438,7395,1427,1470,4206405
4342,81264,2510,2510,2025,2017,485,493,2501.0,,2125.0,,376.0,,2433,2433,1907,1886,526,547,4211892
4343,81272,32165,32165,26013,26548,6152,5617,30590.0,,23650.0,,6940.0,,29933,29933,24478,24531,5455,5402,4206504
4344,81280,3128,3128,2635,2634,493,494,3127.0,,2822.0,,305.0,,3045,3045,2596,2528,449,517,4202438
4345,81299,4013,4013,3265,3335,748,678,4038.0,,3457.0,,581.0,,4054,4054,3269,3276,785,778,4206603
4346,81302,1852,1852,1533,1551,319,301,1900.0,,1690.0,,210.0,,1955,1955,1631,1609,324,346,4200754
4347,81310,16868,16868,13598,13810,3270,3058,16545.0,,12939.0,,3606.0,,16512,16512,13390,13356,3122,3156,4206702
4348,81329,2275,2275,1846,1869,429,406,2250.0,,1976.0,,274.0,,2271,2271,1823,1825,448,446,4205555
4349,81337,2986,2986,2477,2519,509,467,2990.0,,2671.0,,319.0,,3016,3016,2507,2491,509,525,4206801
4350,81345,3997,3997,3259,3270,738,727,4052.0,,3677.0,,375.0,,4076,4076,3465,3375,611,701,4218350
4351,81353,15225,15225,11869,12244,3356,2981,14893.0,,11134.0,,3759.0,,14793,14793,11655,11508,3138,3285,4206900
4352,81361,2771,2771,2354,2396,417,375,2794.0,,2506.0,,288.0,,2763,2763,2309,2319,454,444,4207577
4353,81370,42243,42243,34031,34557,8212,7686,40564.0,,32180.0,,8384.0,,40172,40172,33458,32986,6714,7186,4207007
4354,81388,2504,2504,2075,2111,429,393,2483.0,,2298.0,,185.0,,2396,2396,1956,1947,440,449,4202537
4355,81396,11357,11357,9167,9324,2190,2033,10926.0,,8737.0,,2189.0,,10875,10875,8916,8877,1959,1998,4207106
4356,81400,1826,1826,1564,1600,262,226,1772.0,,1678.0,,94.0,,1673,1673,1502,1474,171,199,4206751
4357,81418,9551,9551,7727,7833,1824,1718,9157.0,,7569.0,,1588.0,,8792,8792,7508,7402,1284,1390,4207205
4358,81426,2975,2975,2445,2441,530,534,2974.0,,2735.0,,239.0,,2866,2866,2316,2253,550,613,4205175
4359,81434,39487,39487,30257,30609,9230,8878,37071.0,,26166.0,,10905.0,,36338,36338,28143,27524,8195,8814,4207304
4360,81442,1940,1940,1597,1609,343,331,1908.0,,1740.0,,168.0,,1843,1843,1479,1453,364,390,4211876
4361,81450,4908,4908,4309,4361,599,547,4757.0,,4328.0,,429.0,,4732,4732,4200,4181,532,551,4207403
4362,81469,1889,1889,1640,1659,249,230,1875.0,,1703.0,,172.0,,1908,1908,1629,1615,279,293,4202578
4363,81477,48509,48509,38403,39463,10106,9046,46064.0,,33601.0,,12463.0,,45187,45187,37063,36821,8124,8366,4207502
4364,81485,2463,2463,2103,2074,360,389,2423.0,,2228.0,,195.0,,2354,2354,1970,1958,384,396,4215752
4365,81493,3842,3842,3194,3265,648,577,3825.0,,3467.0,,358.0,,3681,3681,3093,3069,588,612,4207601
4366,81507,2454,2454,1931,1973,523,481,2408.0,,2160.0,,248.0,,2381,2381,1945,1916,436,465,4215695
4367,81515,6061,6061,5081,5151,980,910,5985.0,,5305.0,,680.0,,5841,5841,5001,4965,840,876,4207700
4368,81523,3287,3287,2676,2672,611,615,3254.0,,2951.0,,303.0,,3261,3261,2629,2581,632,680,4215356
4369,81531,7522,7522,6304,6410,1218,1112,7309.0,,6347.0,,962.0,,7313,7313,6154,6029,1159,1284,4207809
4370,81540,2138,2138,1896,1893,242,245,2041.0,,1938.0,,103.0,,1850,1850,1718,1719,132,131,4209177
4371,81558,8029,8029,6610,6689,1419,1340,7939.0,,6702.0,,1237.0,,7932,7932,6487,6469,1445,1463,4207908
4372,81566,2841,2841,2357,2375,484,466,2881.0,,2541.0,,340.0,,2798,2798,2239,2202,559,596,4212056
4373,81574,6011,6011,4952,4962,1059,1049,6042.0,,5129.0,,913.0,,5924,5924,4719,4717,1205,1207,4208005
4374,81582,2892,2892,2384,2412,508,480,2891.0,,2567.0,,324.0,,2782,2782,2198,2224,584,558,4202081
4375,81590,17012,17012,13516,13853,3496,3159,16543.0,,13075.0,,3468.0,,16594,16594,13260,13292,3334,3302,4208104
4376,81604,1731,1731,1445,1428,286,303,1684.0,,1526.0,,158.0,,1681,1681,1367,1344,314,337,4205357
4377,81612,163901,163901,135292,136402,28609,27499,147784.0,,113680.0,,34104.0,,133093,133093,120118,119149,12975,13944,4208203
4378,81620,1762,1762,1554,1549,208,213,1746.0,,1656.0,,90.0,,1715,1715,1528,1517,187,198,4204756
4379,81639,50477,50477,39565,40299,10912,10178,44264.0,,31335.0,,12929.0,,41581,41581,33276,32941,8305,8640,4208302
4380,81647,2562,2562,2131,2168,431,394,2529.0,,2284.0,,245.0,,2553,2553,2109,2087,444,466,4214151
4381,81655,12358,12358,10232,10365,2126,1993,12143.0,,10207.0,,1936.0,,12259,12259,10316,10236,1943,2023,4208401
4382,81663,17560,17560,13720,13919,3840,3641,14481.0,,11179.0,,3302.0,,13116,13116,10730,10591,2386,2525,4208450
4383,81671,19075,19075,16005,16392,3070,2683,18392.0,,15169.0,,3223.0,,18313,18313,15572,15474,2741,2839,4208500
4384,81680,1999,1999,1677,1676,322,323,1973.0,,1793.0,,180.0,,1929,1929,1559,1574,370,355,4217956
4385,81698,3803,3803,3284,3310,519,493,3776.0,,3467.0,,309.0,,3690,3690,3119,3133,571,557,4208609
4386,81701,2564,2564,2264,2316,300,248,2515.0,,2385.0,,130.0,,2398,2398,2131,2102,267,296,4204194
4387,81710,9107,9107,7492,7641,1615,1466,9061.0,,7896.0,,1165.0,,9114,9114,7461,7456,1653,1658,4208708
4388,81728,11564,11564,8682,8792,2882,2772,10880.0,,8048.0,,2832.0,,10470,10470,7927,7690,2543,2780,4201950
4389,81736,15206,15206,12258,12543,2948,2663,14539.0,,11739.0,,2800.0,,14430,14430,11739,11642,2691,2788,4208807
4390,81744,10527,10527,8041,8197,2486,2330,9408.0,,7280.0,,2128.0,,8637,8637,6597,6462,2040,2175,4202073
4391,81752,122232,122232,105143,106422,17089,15810,114223.0,,89476.0,,24747.0,,109363,109363,99552,99080,9811,10283,4208906
4392,81760,1844,1844,1483,1511,361,333,1865.0,,1613.0,,252.0,,1898,1898,1507,1507,391,391,4202099
4393,81779,22613,22613,18332,18596,4281,4017,22154.0,,17072.0,,5082.0,,22129,22129,18053,17891,4076,4238,4209003
4394,81787,2772,2772,2316,2306,456,466,2753.0,,2479.0,,274.0,,2807,2807,2302,2246,505,561,4202875
4395,81795,428730,428730,356956,360649,71774,68081,403526.0,403526.0,302119.0,289069.0,101407.0,114457.0,396700,396700,343065,341747,53635,54953,4209102
4396,81809,5017,5017,4310,4373,707,644,5002.0,,4223.0,,779.0,,4913,4913,4227,4222,686,691,4210035
4397,81817,2028,2028,1720,1761,308,267,2001.0,,1739.0,,262.0,,2014,2014,1713,1695,301,319,4209201
4398,81825,2997,2997,2519,2613,478,384,2874.0,,2592.0,,282.0,,2671,2671,2316,2303,355,368,4219853
4399,81833,125963,125963,99966,101535,25997,24428,123001.0,,88827.0,,34174.0,,123514,123514,98497,98080,25017,25434,4209300
4400,81850,35918,35918,28520,28504,7398,7414,34550.0,,25771.0,,8779.0,,34824,34824,27945,27231,6879,7593,4209409
4401,81876,5985,5985,5113,5244,872,741,5928.0,,5103.0,,825.0,,5624,5624,4844,4843,780,781,4209508
4402,81892,12290,12290,10205,10253,2085,2037,12223.0,,10491.0,,1732.0,,12285,12285,10367,10094,1918,2191,4209607
4403,81914,8901,8901,6806,6852,2095,2049,8943.0,,7210.0,,1733.0,,9042,9042,6945,6838,2097,2204,4209706
4404,81930,3182,3182,2739,2756,443,426,3104.0,,2877.0,,227.0,,2999,2999,2551,2545,448,454,4209805
4405,81957,8999,8999,7353,7505,1646,1494,8940.0,,7458.0,,1482.0,,8403,8403,6890,6863,1513,1540,4209904
4406,81973,9930,9930,8477,8550,1453,1380,9660.0,,8529.0,,1131.0,,8817,8817,7606,7588,1211,1229,4210001
4407,81990,41455,41455,34839,35333,6616,6122,40255.0,,32697.0,,7558.0,,38777,38777,34829,34747,3948,4030,4210100
4408,82015,3109,3109,2518,2597,591,512,3058.0,,2743.0,,315.0,,3054,3054,2538,2472,516,582,4210209
4409,82031,5909,5909,4888,4960,1021,949,5758.0,,4976.0,,782.0,,5751,5751,4722,4714,1029,1037,4210308
4410,82058,20302,20302,16574,16449,3728,3853,19664.0,,15468.0,,4196.0,,19374,19374,15903,15833,3471,3541,4210506
4411,82066,2004,2004,1797,1764,207,240,2007.0,,1948.0,,59.0,,1856,1856,1711,1708,145,148,4210555
4412,82074,13038,13038,11055,11237,1983,1801,12806.0,,10803.0,,2003.0,,12515,12515,10577,10560,1938,1955,4210605
4413,82090,2464,2464,1895,1861,569,603,2454.0,,2092.0,,362.0,,2407,2407,1779,1740,628,667,4210704
4414,82112,6039,6039,5086,5199,953,840,5965.0,,5312.0,,653.0,,5907,5907,5050,4991,857,916,4210803
4415,82139,3398,3398,2928,2967,470,431,3329.0,,3028.0,,301.0,,3332,3332,2892,2823,440,509,4210902
4416,82155,7683,7683,6331,6399,1352,1284,7660.0,,6491.0,,1169.0,,7608,7608,6210,6194,1398,1414,4211009
4417,82171,7164,7164,5609,5673,1555,1491,7211.0,,5896.0,,1315.0,,6903,6903,5432,5392,1471,1511,4211108
4418,82198,13471,13471,11125,11338,2346,2133,13183.0,,11122.0,,2061.0,,13085,13085,11097,11043,1988,2042,4211207
4419,82210,61069,61069,45961,46996,15108,14073,56001.0,,40321.0,,15680.0,,49673,49673,39162,38924,10511,10749,4211306
4420,82236,3862,3862,3335,3392,527,470,3810.0,,3412.0,,398.0,,3816,3816,3290,3277,526,539,4211405
4421,82252,10774,10774,9105,9347,1669,1427,10432.0,,8917.0,,1515.0,,10327,10327,8898,8943,1429,1384,4211504
4422,82279,12194,12194,10303,10479,1891,1715,11914.0,,10291.0,,1623.0,,11872,11872,10159,10030,1713,1842,4211603
4423,82295,19188,19188,15666,15926,3522,3262,18824.0,,15376.0,,3448.0,,18910,18910,15689,15538,3221,3372,4211702
4424,82317,5819,5819,4862,4966,957,853,5800.0,,4932.0,,868.0,,5870,5870,4891,4894,979,976,4211801
4425,82333,140096,140096,113932,114580,26164,25516,126585.0,,91639.0,,34946.0,,122778,122778,104393,103615,18385,19163,4211900
4426,82350,5726,5726,4527,4546,1199,1180,5760.0,,4741.0,,1019.0,,5732,5732,4439,4372,1293,1360,4212007
4427,82376,12227,12227,10073,10274,2154,1953,12070.0,,9957.0,,2113.0,,11875,11875,10161,10134,1714,1741,4212106
4428,82392,14318,14318,12209,12399,2109,1919,13785.0,,11883.0,,1902.0,,13341,13341,11904,11953,1437,1388,4212205
4429,82414,6622,6622,5629,5682,993,940,6257.0,,5474.0,,783.0,,5968,5968,5266,5179,702,789,4212304
4430,82430,4153,4153,3390,3451,763,702,4188.0,,3757.0,,431.0,,3917,3917,3319,3241,598,676,4212403
4431,82457,22174,22174,17712,18019,4462,4155,19896.0,,15323.0,,4573.0,,17563,17563,15442,15287,2121,2276,4212502
4432,82473,2744,2744,2363,2390,381,354,2736.0,,2549.0,,187.0,,2814,2814,2372,2365,442,449,4212601
4433,82490,5399,5399,4708,4711,691,688,5212.0,,4670.0,,542.0,,5190,5190,4479,4512,711,678,4212700
4434,82511,18484,18484,14451,14781,4033,3703,16089.0,,12289.0,,3800.0,,13732,13732,11957,11818,1775,1914,4212809
4435,82538,15074,15074,12952,13069,2122,2005,14367.0,,12307.0,,2060.0,,13788,13788,12211,12135,1577,1653,4212908
4436,82554,2802,2802,2374,2431,428,371,2704.0,,2428.0,,276.0,,2630,2630,2248,2274,382,356,4213005
4437,82570,5079,5079,4347,4386,732,693,5118.0,,4736.0,,382.0,,4677,4677,4091,4051,586,626,4213104
4438,82597,25935,25935,21231,21284,4704,4651,24557.0,,19037.0,,5520.0,,24322,24322,20381,20353,3941,3969,4213203
4439,82619,4152,4152,3298,3330,854,822,4132.0,,3423.0,,709.0,,4067,4067,3224,3144,843,923,4213302
4440,82635,7965,7965,6536,6658,1429,1307,7806.0,,6639.0,,1167.0,,7605,7605,6568,6490,1037,1115,4213401
4441,82651,16821,16821,12947,13167,3874,3654,14752.0,,10704.0,,4048.0,,13703,13703,10822,10665,2881,3038,4213500
4442,82678,25794,25794,19922,20292,5872,5502,25510.0,,18604.0,,6906.0,,25996,25996,20053,19931,5943,6065,4213609
4443,82694,11816,11816,9754,9918,2062,1898,11435.0,,9690.0,,1745.0,,11387,11387,9344,9266,2043,2121,4213708
4444,82716,6354,6354,5309,5322,1045,1032,6110.0,,5355.0,,755.0,,6100,6100,5140,4995,960,1105,4213807
4445,82732,1627,1627,1404,1420,223,207,1632.0,,1553.0,,79.0,,1579,1579,1384,1374,195,205,4213906
4446,82759,13612,13612,11261,11512,2351,2100,13077.0,,10921.0,,2156.0,,12920,12920,10791,10684,2129,2236,4214003
4447,82775,2197,2197,1787,1826,410,371,2246.0,,2057.0,,189.0,,2179,2179,1709,1716,470,463,4214102
4448,82791,8187,8187,7017,7133,1170,1054,8024.0,,7155.0,,869.0,,7864,7864,6997,6959,867,905,4214201
4449,82813,3146,3146,2720,2722,426,424,3072.0,,2737.0,,335.0,,2809,2809,2499,2427,310,382,4214300
4450,82830,5308,5308,4265,4272,1043,1036,5286.0,,4456.0,,830.0,,5395,5395,4261,4175,1134,1220,4214409
4451,82856,5286,5286,4523,4623,763,663,5184.0,,4717.0,,467.0,,5116,5116,4377,4347,739,769,4214508
4452,82872,5984,5984,5070,5202,914,782,5940.0,,5161.0,,779.0,,5848,5848,5012,5012,836,836,4214607
4453,82899,8800,8800,7271,7441,1529,1359,8662.0,,7299.0,,1363.0,,8381,8381,6975,6992,1406,1389,4214706
4454,82910,51421,51421,41156,42119,10265,9302,49829.0,,36753.0,,13076.0,,49269,49269,39912,39736,9357,9533,4214805
4455,82937,4346,4346,3928,3975,418,371,4327.0,,4037.0,,290.0,,4326,4326,3911,3863,415,463,4214904
4456,82953,32189,32189,25114,25623,7075,6566,31476.0,,24021.0,,7455.0,,31492,31492,24795,24764,6697,6728,4215000
4457,82970,9780,9780,8007,8179,1773,1601,9822.0,,8150.0,,1672.0,,9241,9241,7753,7750,1488,1491,4215109
4458,82996,3934,3934,3405,3405,529,529,3805.0,,3491.0,,314.0,,3650,3650,3280,3267,370,383,4215208
4459,83011,6062,6062,5073,5170,989,892,6004.0,,5182.0,,822.0,,6006,6006,4994,4961,1012,1045,4215307
4460,83038,3462,3462,2911,2953,551,509,3475.0,,3091.0,,384.0,,3564,3564,2933,2926,631,638,4215406
4461,83054,13032,13032,9547,9704,3485,3328,12939.0,,9406.0,,3533.0,,13078,13078,9719,9569,3359,3509,4215505
4462,83070,1981,1981,1709,1735,272,246,1994.0,,1895.0,,99.0,,1949,1949,1684,1659,265,290,4215604
4463,83097,19055,19055,16265,16404,2790,2651,17936.0,,14410.0,,3526.0,,17626,17626,15557,15489,2069,2137,4215703
4464,83119,63102,63102,51285,52310,11817,10792,61672.0,,46917.0,,14755.0,,61078,61078,50623,50823,10455,10255,4215802
4465,83135,2777,2777,2399,2431,378,346,2707.0,,2395.0,,312.0,,2655,2655,2340,2328,315,327,4215901
4466,83151,8259,8259,7036,7102,1223,1157,8202.0,,7042.0,,1160.0,,8248,8248,6942,6927,1306,1321,4216008
4467,83178,7279,7279,6221,6311,1058,968,7107.0,,6390.0,,717.0,,6937,6937,6246,6181,691,756,4216107
4468,83194,39643,39643,30095,30506,9548,9137,37386.0,,27402.0,,9984.0,,36840,36840,27842,27840,8998,9000,4216206
4469,83216,22763,22763,18127,18641,4636,4122,22008.0,,16772.0,,5236.0,,21341,21341,17484,17436,3857,3905,4216305
4470,83232,6687,6687,5691,5734,996,953,6397.0,,5566.0,,831.0,,6270,6270,5407,5249,863,1021,4216404
4471,83259,19332,19332,15176,15396,4156,3936,18997.0,,14391.0,,4606.0,,19239,19239,15335,15081,3904,4158,4216503
4472,83275,186561,186561,153056,153613,33505,32948,170817.0,,120368.0,,50449.0,,167082,167082,143423,142285,23659,24797,4216602
4473,83291,11360,11360,9259,9475,2101,1885,11370.0,,9530.0,,1840.0,,11423,11423,9133,9258,2290,2165,4216701
4474,83313,7444,7444,6243,6317,1201,1127,7166.0,,6457.0,,709.0,,7034,7034,5758,5735,1276,1299,4216800
4475,83330,19151,19151,15372,15544,3779,3607,18668.0,,14875.0,,3793.0,,18411,18411,14958,14827,3453,3584,4216909
4476,83356,9205,9205,7869,7981,1336,1224,8838.0,,7474.0,,1364.0,,8777,8777,7636,7514,1141,1263,4217006
4477,83372,3238,3238,2839,2874,399,364,3257.0,,2980.0,,277.0,,3223,3223,2826,2817,397,406,4217105
4478,83399,31895,31895,25483,25941,6412,5954,30930.0,,23434.0,,7496.0,,30398,30398,24264,24111,6134,6287,4217204
4479,83410,7522,7522,6659,6712,863,810,7421.0,,6709.0,,712.0,,7350,7350,6588,6521,762,829,4217303
4480,83437,13827,13827,11555,11746,2272,2081,13330.0,,10884.0,,2446.0,,13418,13418,11393,11396,2025,2022,4217402
4481,83453,14543,14543,11885,12021,2658,2522,14346.0,,11829.0,,2517.0,,14238,14238,11533,11572,2705,2666,4217501
4482,83470,11105,11105,8742,8946,2363,2159,10922.0,,9041.0,,1881.0,,10969,10969,8853,8816,2116,2153,4217600
4483,83496,22701,22701,18139,18472,4562,4229,22218.0,,17501.0,,4717.0,,21859,21859,17499,17284,4360,4575,4217709
4484,83518,14528,14528,11989,12208,2539,2320,14169.0,,11863.0,,2306.0,,13947,13947,11693,11615,2254,2332,4217808
4485,83534,6601,6601,5527,5611,1074,990,6499.0,,5571.0,,928.0,,6419,6419,5564,5527,855,892,4217907
4486,83550,31771,31771,24964,25360,6807,6411,28948.0,,21892.0,,7056.0,,27508,27508,21880,21830,5628,5678,4218004
4487,83577,34153,34153,28092,28610,6061,5543,32602.0,,24842.0,,7760.0,,32189,32189,27023,26932,5166,5257,4218202
4488,83593,14947,14947,11689,11816,3258,3131,14696.0,,11981.0,,2715.0,,14525,14525,11194,11204,3331,3321,4218301
4489,83615,6591,6591,5607,5678,984,913,6528.0,,5813.0,,715.0,,6188,6188,5307,5323,881,865,4218400
4490,83631,6162,6162,5199,5271,963,891,5905.0,,5109.0,,796.0,,5763,5763,4806,4815,957,948,4218509
4491,83658,5234,5234,4408,4549,826,685,5097.0,,4431.0,,666.0,,4876,4876,4338,4360,538,516,4218608
4492,83674,81025,81025,64908,66093,16117,14932,78494.0,,56842.0,,21652.0,,78125,78125,63510,63195,14615,14930,4218707
4493,83682,4035,4035,3440,3512,595,523,3943.0,,3522.0,,421.0,,3881,3881,3379,3386,502,495,4218756
4494,83690,9957,9957,8642,8746,1315,1211,9589.0,,8682.0,,907.0,,8986,8986,8246,8163,740,823,4218806
4495,83712,8402,8402,6434,6633,1968,1769,8289.0,,6357.0,,1932.0,,8278,8278,6333,6234,1945,2044,4218905
4496,83739,17472,17472,13246,13674,4226,3798,17263.0,,13556.0,,3707.0,,17351,17351,13670,13718,3681,3633,4219002
4497,83755,2933,2933,2556,2553,377,380,2834.0,,2597.0,,237.0,,2682,2682,2429,2398,253,284,4219101
4498,83771,5349,5349,4596,4646,753,703,5286.0,,4815.0,,471.0,,5156,5156,4531,4749,625,407,4219200
4499,83798,38678,38678,30725,31417,7953,7261,37714.0,,29089.0,,8625.0,,37351,37351,29415,29502,7936,7849,4219309
4500,83810,3466,3466,2906,2928,560,538,3416.0,,3109.0,,307.0,,3287,3287,2766,2733,521,554,4219408
4501,83836,36065,36065,29177,29675,6888,6390,35687.0,,26704.0,,8983.0,,34514,34514,27746,27905,6768,6609,4219507
4502,83852,3520,3520,3077,3129,443,391,3525.0,,3293.0,,232.0,,3532,3532,3066,3013,466,519,4219606
4503,83879,22602,22602,18911,19118,3691,3484,21974.0,,18392.0,,3582.0,,21741,21741,17995,17963,3746,3778,4219705
4504,83895,3631,3631,2917,2946,714,685,3593.0,,3122.0,,471.0,,3614,3614,2930,2815,684,799,4202503
4505,83909,12430,12430,9583,9612,2847,2818,12180.0,,9610.0,,2570.0,,11002,11002,8541,8299,2461,2703,4220000
4506,83917,6316,6316,5308,5337,1008,979,6209.0,,5606.0,,603.0,,6144,6144,5232,5201,912,943,4210407
4507,83925,7677,7677,6819,6759,858,918,7365.0,,6670.0,,695.0,,6776,6776,6220,6139,556,637,4212650
4508,83933,4525,4525,3735,3761,790,764,4484.0,,3956.0,,528.0,,4573,4573,3823,3727,750,846,4218103
4509,83950,11889,11889,9950,10052,1939,1837,11713.0,,9864.0,,1849.0,,11688,11688,9618,9585,2070,2103,4204558
4510,83976,13366,13366,10986,11108,2380,2258,13454.0,,11487.0,,1967.0,,12936,12936,10541,10438,2395,2498,4211751
4511,84514,9192,9192,7119,7096,2073,2096,8920.0,,7197.0,,1723.0,,8752,8752,7199,7112,1553,1640,4104451
4512,84530,11605,11605,9473,9519,2132,2086,11264.0,,9165.0,,2099.0,,11058,11058,9396,9386,1662,1672,4127965
4513,84557,3402,3402,2646,2641,756,761,3311.0,,2913.0,,398.0,,3293,3293,2615,2592,678,701,4100459
4514,84573,6483,6483,5070,5094,1413,1389,6429.0,,5230.0,,1199.0,,6413,6413,5304,5208,1109,1205,4107751
4515,84590,4225,4225,3336,3333,889,892,4115.0,,3393.0,,722.0,,4002,4002,3367,3337,635,665,4113759
4516,84611,68592,68592,53316,54219,15276,14373,64050.0,,46265.0,,17785.0,,60122,60122,50166,50210,9956,9912,4126256
4517,84638,6302,6302,4978,5117,1324,1185,6320.0,,5014.0,,1306.0,,6187,6187,5040,4916,1147,1271,4112959
4518,84654,6698,6698,5385,5533,1313,1165,6588.0,,5443.0,,1145.0,,6435,6435,5536,5530,899,905,4107256
4519,84670,17990,17990,14842,14930,3148,3060,17219.0,,14234.0,,2985.0,,16807,16807,14083,14050,2724,2757,4124053
4520,84697,9344,9344,7741,7768,1603,1576,9253.0,,7835.0,,1418.0,,8951,8951,7419,7347,1532,1604,4116059
4521,84719,3317,3317,2739,2744,578,573,3245.0,,2852.0,,393.0,,3010,3010,2654,2665,356,345,4125456
4522,84735,3108,3108,2806,2845,302,263,3038.0,,2887.0,,151.0,,2958,2958,2725,2706,233,252,4301552
4523,84743,2459,2459,2096,2135,363,324,2452.0,,2174.0,,278.0,,2441,2441,2131,2140,310,301,4321634
4524,84751,3063,3063,2683,2714,380,349,3018.0,,2777.0,,241.0,,2969,2969,2633,2634,336,335,4313359
4525,84760,4939,4939,4332,4370,607,569,4787.0,,4508.0,,279.0,,4705,4705,4203,4137,502,568,4315156
4526,84778,2299,2299,1725,1773,574,526,2320.0,,2072.0,,248.0,,2204,2204,1726,1717,478,487,4314555
4527,84786,3243,3243,2677,2747,566,496,3255.0,,2962.0,,293.0,,3056,3056,2545,2519,511,537,4310850
4528,84794,2457,2457,2156,2217,301,240,2434.0,,2283.0,,151.0,,2421,2421,2147,2118,274,303,4318440
4529,84808,1770,1770,1529,1540,241,230,1800.0,,1645.0,,155.0,,1691,1691,1502,1485,189,206,4300554
4530,84816,14457,14457,12376,12488,2081,1969,14226.0,,12231.0,,1995.0,,13865,13865,12275,12129,1590,1736,4313060
4531,84824,2997,2997,2544,2579,453,418,2981.0,,2733.0,,248.0,,2824,2824,2418,2398,406,426,4306452
4532,84832,2628,2628,2241,2296,387,332,2617.0,,2413.0,,204.0,,2601,2601,2226,2206,375,395,4318051
4533,84840,3353,3353,2786,2798,567,555,3342.0,,3153.0,,189.0,,3184,3184,2735,2711,449,473,4322152
4534,84859,4133,4133,3598,3668,535,465,4086.0,,3762.0,,324.0,,4014,4014,3569,3548,445,466,4318424
4535,84867,1407,1407,1188,1223,219,184,1421.0,,1285.0,,136.0,,1384,1384,1208,1201,176,183,4309258
4536,84875,3616,3616,3093,3091,523,525,3516.0,,3091.0,,425.0,,3335,3335,2953,2896,382,439,4315354
4537,84883,3941,3941,3376,3357,565,584,3938.0,,3480.0,,458.0,,3964,3964,3498,3495,466,469,4306734
4538,84891,7763,7763,6596,6586,1167,1177,7440.0,,6402.0,,1038.0,,7087,7087,6199,6111,888,976,4304689
4539,84905,3497,3497,2745,2782,752,715,3450.0,,3084.0,,366.0,,3266,3266,2688,2539,578,727,4311122
4540,84913,2030,2030,1735,1766,295,264,2053.0,,1952.0,,101.0,,1899,1899,1653,1637,246,262,4322558
4541,84921,5444,5444,4621,4657,823,787,5422.0,,4935.0,,487.0,,5369,5369,4700,4631,669,738,4302451
4542,84930,2351,2351,2070,2114,281,237,2356.0,,2194.0,,162.0,,2262,2262,1993,1977,269,285,4307864
4543,84948,3099,3099,2703,2765,396,334,3003.0,,2766.0,,237.0,,2951,2951,2588,2578,363,373,4300059
4544,84956,2232,2232,1841,1890,391,342,2233.0,,1943.0,,290.0,,2221,2221,1895,1882,326,339,4320651
4545,84964,3516,3516,2920,2987,596,529,3556.0,,3213.0,,343.0,,3418,3418,2905,2812,513,606,4309951
4546,84972,3578,3578,3049,3044,529,534,3539.0,,3365.0,,174.0,,3409,3409,3042,3012,367,397,4309753
4547,84980,8252,8252,6686,6678,1566,1574,8210.0,,7127.0,,1083.0,,7889,7889,6626,6479,1263,1410,4313953
4548,84999,5478,5478,4620,4697,858,781,5370.0,,4765.0,,605.0,,5297,5297,4571,4534,726,763,4310439
4549,85006,5129,5129,4316,4425,813,704,4960.0,,4531.0,,429.0,,4629,4629,3974,3978,655,651,4321956
4550,85014,12429,12429,11036,11012,1393,1417,12138.0,,11070.0,,1068.0,,11910,11910,11046,10900,864,1010,4300109
4551,85022,2830,2830,2404,2402,426,428,2773.0,,2454.0,,319.0,,2678,2678,2313,2289,365,389,4307054
4552,85030,5905,5905,4998,5076,907,829,5868.0,,4987.0,,881.0,,5886,5886,5027,5012,859,874,4300208
4553,85049,2566,2566,2080,2085,486,481,2545.0,,2272.0,,273.0,,2537,2537,2056,2019,481,518,4306353
4554,85057,5484,5484,4699,4722,785,762,5395.0,,4835.0,,560.0,,5182,5182,4629,4587,553,595,4300307
4555,85065,3878,3878,3383,3406,495,472,3794.0,,3456.0,,338.0,,3703,3703,3359,3352,344,351,4302659
4556,85073,58455,58455,42807,43119,15648,15336,58603.0,,39134.0,,19469.0,,60101,60101,44348,43799,15753,16302,4300406
4557,85081,2537,2537,2092,2145,445,392,2544.0,,2325.0,,219.0,,2525,2525,2058,2073,467,452,4306973
4558,85090,6229,6229,5044,5175,1185,1054,6165.0,,5481.0,,684.0,,6099,6099,5194,5451,905,648,4300505
4559,85103,7279,7279,6016,6112,1263,1167,7114.0,,5839.0,,1275.0,,6959,6959,5997,5983,962,976,4306932
4560,85111,138019,138019,108874,108602,29145,29417,132361.0,,95713.0,,36648.0,,128956,128956,106850,106100,22106,22856,4300604
4561,85120,4252,4252,3582,3586,670,666,4192.0,,3669.0,,523.0,,4062,4062,3535,3486,527,576,4313037
4562,85138,4791,4791,4119,4237,672,554,4750.0,,4301.0,,449.0,,4829,4829,4200,4200,629,629,4300703
4563,85146,5847,5847,4888,4843,959,1004,5853.0,,5082.0,,771.0,,5774,5774,4969,4929,805,845,4314159
4564,85154,10560,10560,9153,9361,1407,1199,10276.0,,8740.0,,1536.0,,9988,9988,9025,9056,963,932,4300802
4565,85162,7609,7609,6184,6273,1425,1336,7365.0,,5806.0,,1559.0,,7289,7289,6013,5939,1276,1350,4321436
4566,85170,6287,6287,5384,5474,903,813,6273.0,,5840.0,,433.0,,6052,6052,5331,5298,721,754,4300901
4567,85189,3913,3913,3494,3517,419,396,3812.0,,3393.0,,419.0,,3624,3624,3355,3342,269,282,4309555
4568,85197,16626,16626,14580,14123,2046,2503,16138.0,,14268.0,,1870.0,,15575,15575,14227,13999,1348,1576,4301008
4569,85200,3166,3166,2573,2651,593,515,3159.0,,2923.0,,236.0,,3123,3123,2611,2590,512,533,4304101
4570,85219,10289,10289,8179,8213,2110,2076,10101.0,,8040.0,,2061.0,,10015,10015,8353,8239,1662,1776,4301107
4571,85227,2579,2579,2116,2428,463,151,2488.0,,2381.0,,107.0,,2225,2225,1827,1828,398,397,4305157
4572,85235,10364,10364,8599,8663,1765,1701,10352.0,,9048.0,,1304.0,,10521,10521,8633,8608,1888,1913,4301206
4573,85243,1969,1969,1695,1736,274,233,1948.0,,1851.0,,97.0,,1883,1883,1648,1654,235,229,4310462
4574,85251,14773,14773,11971,11920,2802,2853,14516.0,,11769.0,,2747.0,,14338,14338,12142,11971,2196,2367,4301305
4575,85260,4597,4597,3809,3819,788,778,4600.0,,4133.0,,467.0,,4470,4470,3953,3906,517,564,4311254
4576,85278,8666,8666,7262,7453,1404,1213,8633.0,,7714.0,,919.0,,8694,8694,7330,7276,1364,1418,4301404
4577,85286,4857,4857,4162,4220,695,637,4864.0,,4193.0,,671.0,,4839,4839,4243,4233,596,606,4307559
4578,85294,5782,5782,5046,5168,736,614,5688.0,,5031.0,,657.0,,5492,5492,4923,4897,569,595,4301503
4579,85308,7860,7860,6218,6293,1642,1567,7296.0,,6045.0,,1251.0,,6825,6825,5571,5460,1254,1365,4301057
4580,85316,91389,91389,69482,69197,21907,22192,90929.0,,65475.0,,25454.0,,92121,92121,71009,70222,21112,21899,4301602
4581,85324,3527,3527,3171,3216,356,311,3440.0,,3229.0,,211.0,,3314,3314,3095,3095,219,219,4318481
4582,85332,5402,5402,4669,4762,733,640,5245.0,,4704.0,,541.0,,5077,5077,4607,4612,470,465,4301701
4583,85340,2315,2315,1994,2006,321,309,2250.0,,2054.0,,196.0,,2114,2114,1836,1811,278,303,4314456
4584,85359,4368,4368,3517,3597,851,771,4379.0,,3897.0,,482.0,,4292,4292,3569,3518,723,774,4301800
4585,85367,7873,7873,6831,6958,1042,915,7650.0,,6779.0,,871.0,,7337,7337,6624,6583,713,754,4321667
4586,85375,10335,10335,8113,8110,2222,2225,9951.0,,7805.0,,2146.0,,9782,9782,8086,7987,1696,1795,4301909
4587,85383,2283,2283,2011,2005,272,278,2244.0,,2086.0,,158.0,,2136,2136,1933,1908,203,228,4319752
4588,85391,8429,8429,6804,6780,1625,1649,8303.0,,7470.0,,833.0,,7977,7977,6678,6500,1299,1477,4302006
4589,85405,1881,1881,1644,1690,237,191,1856.0,,1721.0,,135.0,,1850,1850,1670,1663,180,187,4315172
4590,85413,91684,91684,75533,76747,16151,14937,89488.0,,69578.0,,19910.0,,89380,89380,74633,74201,14747,15179,4302105
4591,85421,1632,1632,1404,1430,228,202,1577.0,,1494.0,,83.0,,1527,1527,1322,1309,205,218,4315131
4592,85430,5537,5537,4844,4892,693,645,5435.0,,4946.0,,489.0,,5341,5341,4832,4786,509,555,4302204
4593,85448,2464,2464,2026,2065,438,399,2467.0,,2189.0,,278.0,,2357,2357,1935,1906,422,451,4307831
4594,85456,8363,8363,6592,6677,1771,1686,8255.0,,6948.0,,1307.0,,8341,8341,6637,6565,1704,1776,4302303
4595,85464,6353,6353,5126,5029,1227,1324,6287.0,,5290.0,,997.0,,6183,6183,5090,4912,1093,1271,4306056
4596,85472,9790,9790,8286,8193,1504,1597,9546.0,,8149.0,,1397.0,,9455,9455,8193,8085,1262,1370,4302402
4597,85480,5829,5829,4837,4856,992,973,5716.0,,4955.0,,761.0,,5633,5633,4728,4688,905,945,4319158
4598,85499,5119,5119,4092,4122,1027,997,4937.0,,4177.0,,760.0,,4819,4819,3993,3937,826,882,4302501
4599,85502,6532,6532,5215,5339,1317,1193,6491.0,,5290.0,,1201.0,,6284,6284,5196,5116,1088,1168,4309050
4600,85510,2849,2849,2338,2306,511,543,2886.0,,2609.0,,277.0,,2843,2843,2323,2273,520,570,4302600
4601,85529,5559,5559,4645,4670,914,889,5484.0,,4903.0,,581.0,,5416,5416,4786,4735,630,681,4320263
4602,85537,14864,14864,11918,11915,2946,2949,14566.0,,11449.0,,3117.0,,14167,14167,12103,11879,2064,2288,4302709
4603,85545,3299,3299,2777,2810,522,489,3351.0,,3124.0,,227.0,,3169,3169,2766,2764,403,405,4300455
4604,85553,25232,25232,20155,20357,5077,4875,24562.0,,18718.0,,5844.0,,23362,23362,20056,19780,3306,3582,4302808
4605,85561,2666,2666,2333,2352,333,314,2669.0,,2486.0,,183.0,,2612,2612,2280,2235,332,377,4316436
4606,85570,8575,8575,6733,6735,1842,1840,8354.0,,6828.0,,1526.0,,8292,8292,6970,6811,1322,1481,4302907
4607,85588,2073,2073,1590,1603,483,470,2070.0,,1891.0,,179.0,,2077,2077,1600,1578,477,499,4318465
4608,85596,66949,66949,49599,50031,17350,16918,67076.0,,46372.0,,20704.0,,68844,68844,51287,50530,17557,18314,4303004
4609,85600,2479,2479,2170,2158,309,321,2481.0,,2345.0,,136.0,,2429,2429,2162,2151,267,278,4323507
4610,85618,104314,104314,82060,82986,22254,21328,101919.0,,72046.0,,29873.0,,102562,102562,81859,80943,20703,21619,4303103
4611,85626,1870,1870,1524,1539,346,331,1876.0,,1661.0,,215.0,,1862,1862,1586,1570,276,292,4310751
4612,85634,3986,3986,3390,3467,596,519,3929.0,,3605.0,,324.0,,3868,3868,3314,3323,554,545,4303202
4613,85642,3570,3570,3072,3128,498,442,3513.0,,3176.0,,337.0,,3400,3400,3022,3019,378,381,4323408
4614,85650,4010,4010,3370,3403,640,607,3948.0,,3507.0,,441.0,,3925,3925,3393,3322,532,603,4303301
4615,85669,2729,2729,2388,2423,341,306,2633.0,,2489.0,,144.0,,2563,2563,2222,2218,341,345,4321329
4616,85677,4272,4272,3635,3661,637,611,4186.0,,3801.0,,385.0,,4037,4037,3512,3504,525,533,4303400
4617,85685,20805,20805,15374,15564,5431,5241,19653.0,,13449.0,,6204.0,,18214,18214,13652,13395,4562,4819,4310330
4618,85693,50698,50698,39939,40157,10759,10541,50455.0,,37894.0,,12561.0,,51231,51231,40468,39843,10763,11388,4303509
4619,85707,2413,2413,2108,2099,305,314,2381.0,,2203.0,,178.0,,2224,2224,1944,1963,280,261,4320230
4620,85715,4937,4937,4070,4128,867,809,4947.0,,4410.0,,537.0,,4883,4883,4180,4049,703,834,4303608
4621,85723,4240,4240,3736,3755,504,485,4174.0,,3886.0,,288.0,,3907,3907,3514,3469,393,438,4322251
4622,85731,5143,5143,4411,4434,732,709,5111.0,,4508.0,,603.0,,5080,5080,4474,4438,606,642,4303707
4623,85740,4018,4018,3430,3471,588,547,3974.0,,3609.0,,365.0,,3798,3798,3296,3269,502,529,4315750
4624,85758,4602,4602,3961,4014,641,588,4537.0,,4141.0,,396.0,,4516,4516,3975,3954,541,562,4303806
4625,85766,2057,2057,1660,1723,397,334,2058.0,,1928.0,,130.0,,2016,2016,1612,1599,404,417,4315453
4626,85774,52843,52843,43045,43491,9798,9352,52005.0,,39526.0,,12479.0,,52264,52264,43480,43078,8784,9186,4303905
4627,85782,2689,2689,2205,2188,484,501,2738.0,,2385.0,,353.0,,2663,2663,2221,2200,442,463,4310363
4628,85790,4099,4099,3276,3285,823,814,4181.0,,3579.0,,602.0,,4160,4160,3397,3391,763,769,4304002
4629,85804,11268,11268,8234,8184,3034,3084,10851.0,,8392.0,,2459.0,,9253,9253,7428,7232,1825,2021,4305454
4630,85812,22443,22443,18816,18578,3627,3865,21896.0,,18791.0,,3105.0,,20950,20950,18838,18714,2112,2236,4304200
4631,85820,1474,1474,1238,1290,236,184,1504.0,,1401.0,,103.0,,1487,1487,1270,1289,217,198,4312351
4632,85839,5537,5537,4979,5035,558,502,5490.0,,5142.0,,348.0,,5388,5388,4938,4910,450,478,4304309
4633,85847,2653,2653,2197,2192,456,461,2626.0,,2380.0,,246.0,,2521,2521,2097,2058,424,463,4323705
4634,85855,34374,34374,26613,26873,7761,7501,32991.0,,23803.0,,9188.0,,31263,31263,24867,24504,6396,6759,4304408
4635,85863,1600,1600,1367,1408,233,192,1586.0,,1511.0,,75.0,,1506,1506,1288,1292,218,214,4323606
4636,85871,44305,44305,35094,35054,9211,9251,43996.0,,34233.0,,9763.0,,44673,44673,35778,35348,8895,9325,4304507
4637,85880,3094,3094,2562,2624,532,470,3107.0,,2971.0,,136.0,,2702,2702,2305,2293,397,409,4304952
4638,85898,258232,258232,206343,206777,51889,51455,250704.0,250704.0,179954.0,171316.0,70750.0,79388.0,252200,252200,205175,202797,47025,49403,4304606
4639,85901,2683,2683,2148,2158,535,525,2653.0,,2377.0,,276.0,,2567,2567,2039,2013,528,554,4310553
4640,85910,47226,47226,37854,38377,9372,8849,47140.0,,36255.0,,10885.0,,47272,47272,37897,37620,9375,9652,4304705
4641,85928,2661,2661,2119,2166,542,495,2688.0,,2425.0,,263.0,,2670,2670,2120,2108,550,562,4306957
4642,85936,22780,22780,19972,20203,2808,2577,21675.0,,18685.0,,2990.0,,20699,20699,18853,18748,1846,1951,4304804
4643,85944,6929,6929,5776,5872,1153,1057,6821.0,,5949.0,,872.0,,6727,6727,5795,5753,932,974,4305173
4644,85952,7633,7633,6405,6566,1228,1067,7560.0,,6424.0,,1136.0,,7619,7619,6365,6327,1254,1292,4304903
4645,85960,2500,2500,2124,2174,376,326,2460.0,,2276.0,,184.0,,2361,2361,2053,2036,308,325,4303558
4646,85979,7513,7513,6464,6563,1049,950,7329.0,,6413.0,,916.0,,7155,7155,6318,6280,837,875,4305009
4647,85987,5331,5331,4596,4596,735,735,5291.0,,4747.0,,544.0,,5174,5174,4701,4627,473,547,4314027
4648,85995,343453,343453,281708,285254,61745,58199,333696.0,333696.0,250972.0,249045.0,82724.0,84651.0,322901,322901,277566,276885,45335,46016,4305108
4649,86010,10067,10067,8543,8593,1524,1474,9775.0,,8312.0,,1463.0,,9525,9525,8384,8341,1141,1184,4305207
4650,86029,2335,2335,1922,1950,413,385,2360.0,,2079.0,,281.0,,2283,2283,1886,1859,397,424,4308052
4651,86037,7773,7773,6763,6853,1010,920,7656.0,,6964.0,,692.0,,7509,7509,6665,6629,844,880,4305306
4652,86045,4631,4631,3786,3756,845,875,4617.0,,4130.0,,487.0,,4547,4547,3841,3726,706,821,4300638
4653,86053,3502,3502,2914,2944,588,558,3554.0,,3185.0,,369.0,,3430,3430,2770,2742,660,688,4305405
4654,86061,3289,3289,2898,2943,391,346,3268.0,,2956.0,,312.0,,3189,3189,2856,2844,333,345,4323309
4655,86070,3692,3692,3185,3231,507,461,3643.0,,3414.0,,229.0,,3624,3624,3154,3141,470,483,4305504
4656,86088,3656,3656,2977,2991,679,665,3678.0,,3248.0,,430.0,,3679,3679,3153,3082,526,597,4305132
4657,86096,3034,3034,2547,2600,487,434,3110.0,,2832.0,,278.0,,3048,3048,2625,2593,423,455,4305603
4658,86100,1331,1331,1119,1100,212,231,1324.0,,1226.0,,98.0,,1250,1250,1033,1019,217,231,4300661
4659,86118,5902,5902,4759,4798,1143,1104,5637.0,,4838.0,,799.0,,5550,5550,4660,4691,890,859,4305702
4660,86126,2001,2001,1702,1701,299,300,2028.0,,1877.0,,151.0,,1973,1973,1682,1665,291,308,4314753
4661,86134,8257,8257,6765,7040,1492,1217,8129.0,,6845.0,,1284.0,,7960,7960,6694,6733,1266,1227,4305801
4662,86142,3883,3883,3285,3339,598,544,3805.0,,3561.0,,244.0,,3691,3691,3255,3217,436,474,4321857
4663,86150,6031,6031,4858,4881,1173,1150,5983.0,,5245.0,,738.0,,5895,5895,4576,4515,1319,1380,4305900
4664,86169,2745,2745,2405,2448,340,297,2682.0,,2502.0,,180.0,,2649,2649,2337,2328,312,321,4312757
4665,86177,10756,10756,8743,8820,2013,1936,10707.0,,9083.0,,1624.0,,10654,10654,8964,8935,1690,1719,4306007
4666,86185,5291,5291,4342,4357,949,934,5241.0,,4273.0,,968.0,,5199,5199,4426,4381,773,818,4312450
4667,86193,47645,47645,36937,37101,10708,10544,47983.0,,35840.0,,12143.0,,48334,48334,37330,36621,11004,11713,4306106
4668,86207,5171,5171,4699,4709,472,462,5106.0,,4714.0,,392.0,,4988,4988,4641,4634,347,354,4316956
4669,86215,9478,9478,8196,8107,1282,1371,9244.0,,8043.0,,1201.0,,8904,8904,7938,7884,966,1020,4306205
4670,86223,4952,4952,4415,4430,537,522,4818.0,,4347.0,,471.0,,4746,4746,4311,4301,435,445,4301651
4671,86231,3993,3993,3434,3508,559,485,4004.0,,3704.0,,300.0,,3928,3928,3410,3395,518,533,4306304
4672,86240,26046,26046,21432,21475,4614,4571,24279.0,,19377.0,,4902.0,,20980,20980,18686,18476,2294,2504,4306767
4673,86258,24739,24739,20864,21265,3875,3474,24308.0,,19544.0,,4764.0,,23714,23714,20587,20500,3127,3214,4306403
4674,86274,10434,10434,8573,8605,1861,1829,10329.0,,8909.0,,1420.0,,10278,10278,8744,8642,1534,1636,4306502
4675,86282,2751,2751,2331,2359,420,392,2728.0,,2459.0,,269.0,,2559,2559,2256,2225,303,334,4300570
4676,86290,29811,29811,22159,22249,7652,7562,30002.0,,21674.0,,8328.0,,30099,30099,22412,21830,7687,8269,4306601
4677,86304,5772,5772,4998,5096,774,676,5585.0,,5057.0,,528.0,,5261,5261,4571,4561,690,700,4300646
4678,86312,3021,3021,2525,2523,496,498,3034.0,,2741.0,,293.0,,3066,3066,2579,2537,487,529,4306700
4679,86320,3517,3517,2709,2733,808,784,3457.0,,2847.0,,610.0,,3351,3351,2646,2544,705,807,4300851
4680,86339,17674,17674,14200,14335,3474,3339,17486.0,,14183.0,,3303.0,,17583,17583,14368,14141,3215,3442,4306809
4681,86347,4474,4474,3807,3855,667,619,4370.0,,4009.0,,361.0,,4200,4200,3844,3815,356,385,4301750
4682,86355,18851,18851,15195,15315,3656,3536,18396.0,,14931.0,,3465.0,,17998,17998,15280,15117,2718,2881,4306908
4683,86363,2553,2553,2088,2116,465,437,2517.0,,2337.0,,180.0,,2278,2278,1912,1928,366,350,4301859
4684,86371,80420,80420,66105,66852,14315,13568,79288.0,,61938.0,,17350.0,,78822,78822,64846,64248,13976,14574,4307005
4685,86380,1737,1737,1517,1537,220,200,1732.0,,1530.0,,202.0,,1760,1760,1530,1547,230,213,4301925
4686,86398,5234,5234,4023,4031,1211,1203,5262.0,,4285.0,,977.0,,5161,5161,4099,4044,1062,1117,4307104
4687,86401,2680,2680,2310,2346,370,334,2730.0,,2571.0,,159.0,,2604,2604,2253,2225,351,379,4301958
4688,86410,4224,4224,3561,3597,663,627,4122.0,,3687.0,,435.0,,4110,4110,3543,3530,567,580,4307203
4689,86428,1952,1952,1593,1633,359,319,1950.0,,1791.0,,159.0,,1886,1886,1565,1560,321,326,4302154
4690,86436,5530,5530,4638,4651,892,879,5333.0,,4737.0,,596.0,,5395,5395,4627,4608,768,787,4307302
4691,86444,2339,2339,1907,1853,432,486,2313.0,,2166.0,,147.0,,2074,2074,1792,1694,282,380,4302378
4692,86452,2709,2709,2128,2190,581,519,2752.0,,2421.0,,331.0,,2637,2637,2096,2047,541,590,4307401
4693,86460,2712,2712,2249,2307,463,405,2669.0,,2407.0,,262.0,,2578,2578,2215,2250,363,328,4303673
4694,86479,12614,12614,10562,10701,2052,1913,12361.0,,10440.0,,1921.0,,12201,12201,10538,10392,1663,1809,4307500
4695,86487,7914,7914,6454,6338,1460,1576,7662.0,,6466.0,,1196.0,,7306,7306,6160,6093,1146,1213,4304358
4696,86495,37078,37078,30346,30721,6732,6357,36218.0,,27318.0,,8900.0,,35212,35212,29433,29189,5779,6023,4307609
4697,86509,2758,2758,2362,2381,396,377,2730.0,,2638.0,,92.0,,2456,2456,2177,2157,279,299,4304697
4698,86517,68376,68376,53608,53758,14768,14618,67793.0,,47458.0,,20335.0,,68809,68809,54626,53996,14183,14813,4307708
4699,86525,1377,1377,1192,1231,185,146,1380.0,,1308.0,,72.0,,1392,1392,1210,1219,182,173,4304853
4700,86533,25890,25890,21098,20698,4792,5192,25570.0,,20275.0,,5295.0,,25786,25786,21313,20780,4473,5006,4307807
4701,86541,2603,2603,2316,2360,287,243,2574.0,,2442.0,,132.0,,2528,2528,2281,2274,247,254,4305116
4702,86550,57293,57293,47468,48124,9825,9169,56271.0,,45278.0,,10993.0,,55589,55589,47022,46804,8567,8785,4307906
4703,86568,2458,2458,2049,2124,409,334,2279.0,,2077.0,,202.0,,2301,2301,1939,1964,362,337,4305371
4704,86576,5775,5775,4778,4806,997,969,5638.0,,4704.0,,934.0,,5575,5575,4715,4680,860,895,4308003
4705,86584,2274,2274,1966,1932,308,342,2282.0,,2052.0,,230.0,,2241,2241,1964,1932,277,309,4305587
4706,86592,10814,10814,9247,9391,1567,1423,10469.0,,9095.0,,1374.0,,10210,10210,9064,9089,1146,1121,4308102
4707,86606,2336,2336,1999,2040,337,296,2357.0,,2130.0,,227.0,,2268,2268,1955,1941,313,327,4305850
4708,86614,24605,24605,20956,21406,3649,3199,23765.0,,19738.0,,4027.0,,22857,22857,20252,20189,2605,2668,4308201
4709,86622,2556,2556,2225,2221,331,335,2511.0,,2233.0,,278.0,,2412,2412,2088,2090,324,322,4305871
4710,86630,8362,8362,6633,6730,1729,1632,8215.0,,7169.0,,1046.0,,8166,8166,6468,6392,1698,1774,4308300
4711,86649,2666,2666,2291,2315,375,351,2613.0,,2425.0,,188.0,,2464,2464,2167,2128,297,336,4305975
4712,86657,5670,5670,4603,4625,1067,1045,5581.0,,4736.0,,845.0,,5563,5563,4692,4603,871,960,4308409
4713,86665,2751,2751,2247,2236,504,515,2757.0,,2517.0,,240.0,,2697,2697,2248,2183,449,514,4306320
4714,86673,25616,25616,20686,20929,4930,4687,25353.0,,20347.0,,5006.0,,25128,25128,20212,20084,4916,5044,4308508
4715,86681,1929,1929,1634,1644,295,285,1895.0,,1776.0,,119.0,,1876,1876,1605,1605,271,271,4306429
4716,86690,25815,25815,22299,22561,3516,3254,24775.0,,21413.0,,3362.0,,23668,23668,21461,21369,2207,2299,4308607
4717,86703,1213,1213,990,1016,223,197,1173.0,,1023.0,,150.0,,1198,1198,960,966,238,232,4306924
4718,86711,5178,5178,4447,4543,731,635,5129.0,,4499.0,,630.0,,5077,5077,4513,4477,564,600,4308706
4719,86720,2579,2579,2044,2016,535,563,2606.0,,2276.0,,330.0,,2648,2648,2067,2001,581,647,4308656
4720,86738,6215,6215,5061,5092,1154,1123,6147.0,,5228.0,,919.0,,5845,5845,5055,4941,790,904,4308805
4721,86746,1629,1629,1372,1386,257,243,1636.0,,1486.0,,150.0,,1535,1535,1301,1285,234,250,4308854
4722,86754,7232,7232,5559,5649,1673,1583,7145.0,,5695.0,,1450.0,,7386,7386,5557,5434,1829,1952,4319802
4723,86762,2216,2216,1850,1868,366,348,2165.0,,2021.0,,144.0,,2057,2057,1718,1699,339,358,4309126
4724,86770,13216,13216,10536,10741,2680,2475,13171.0,,9960.0,,3211.0,,13343,13343,10857,10762,2486,2581,4308904
4725,86789,3015,3015,2491,2502,524,513,3030.0,,2835.0,,195.0,,2854,2854,2489,2423,365,431,4309159
4726,86797,12809,12809,10629,10771,2180,2038,12563.0,,10842.0,,1721.0,,12405,12405,10741,10685,1664,1720,4309001
4727,86800,4775,4775,3912,3892,863,883,4691.0,,3938.0,,753.0,,4608,4608,3937,3889,671,719,4309654
4728,86819,33455,33455,26394,26774,7061,6681,31892.0,,23988.0,,7904.0,,31354,31354,25259,24982,6095,6372,4309100
4729,86827,1985,1985,1615,1600,370,385,1982.0,,1646.0,,336.0,,2009,2009,1605,1603,404,406,4310413
4730,86835,191626,191626,152041,152559,39585,39067,185345.0,,130452.0,,54893.0,,189422,189422,151047,149740,38375,39682,4309209
4731,86843,1785,1785,1496,1500,289,285,1808.0,,1702.0,,106.0,,1844,1844,1484,1482,360,362,4310579
4732,86851,75682,75682,59811,60141,15871,15541,74487.0,,54242.0,,20245.0,,74115,74115,59349,58816,14766,15299,4309308
4733,86860,2002,2002,1615,1660,387,342,1980.0,,1860.0,,120.0,,1788,1788,1459,1502,329,286,4311429
4734,86878,18695,18695,16000,16254,2695,2441,18127.0,,15496.0,,2631.0,,17611,17611,15746,15697,1865,1914,4309407
4735,86886,1603,1603,1383,1395,220,208,1590.0,,1483.0,,107.0,,1542,1542,1331,1327,211,215,4311270
4736,86894,5916,5916,5115,5134,801,782,5853.0,,5239.0,,614.0,,5756,5756,5238,5201,518,555,4309506
4737,86908,4569,4569,3952,3951,617,618,4466.0,,3984.0,,482.0,,4367,4367,3906,3897,461,470,4311627
4738,86916,14681,14681,12428,12117,2253,2564,14368.0,,12285.0,,2083.0,,14027,14027,12373,12178,1654,1849,4309605
4739,86924,1448,1448,1209,1225,239,223,1414.0,,1247.0,,167.0,,1395,1395,1219,1218,176,177,4311643
4740,86932,25362,25362,20408,20540,4954,4822,25043.0,,19958.0,,5085.0,,25219,25219,20496,20153,4723,5066,4305355
4741,86940,5500,5500,4389,4423,1111,1077,5405.0,,4450.0,,955.0,,5288,5288,4395,4302,893,986,4311759
4742,86959,4099,4099,3486,3538,613,561,4102.0,,3731.0,,371.0,,3994,3994,3539,3518,455,476,4309704
4743,86967,5831,5831,4923,4954,908,877,5714.0,,4903.0,,811.0,,5542,5542,4717,4632,825,910,4311775
4744,86975,3932,3932,3410,3460,522,472,3905.0,,3545.0,,360.0,,3828,3828,3362,3362,466,466,4309803
4745,86983,2323,2323,2020,2014,303,309,2301.0,,2136.0,,165.0,,2179,2179,1950,1942,229,237,4311791
4746,86991,5399,5399,4645,4739,754,660,5343.0,,4846.0,,497.0,,5350,5350,4686,4635,664,715,4309902
4747,87009,3549,3549,2915,2940,634,609,3424.0,,2888.0,,536.0,,3411,3411,2860,2815,551,596,4311981
4748,87017,16258,16258,13873,14030,2385,2228,15882.0,,13600.0,,2282.0,,15608,15608,13762,13632,1846,1976,4310009
4749,87025,2746,2746,2327,2389,419,357,2707.0,,2481.0,,226.0,,2564,2564,2172,2158,392,406,4312138
4750,87033,27529,27529,22809,23013,4720,4516,27239.0,,21716.0,,5523.0,,26894,26894,22619,22434,4275,4460,4310108
4751,87041,3929,3929,3363,3371,566,558,3858.0,,3396.0,,462.0,,3728,3728,3317,3284,411,444,4312153
4752,87050,65021,65021,52862,53454,12159,11567,64384.0,,49657.0,,14727.0,,64622,64622,52507,52089,12115,12533,4310207
4753,87068,6272,6272,5124,5139,1148,1133,6148.0,,5215.0,,933.0,,6044,6044,5134,4999,910,1045,4312252
4754,87076,3586,3586,2994,3042,592,544,3588.0,,3306.0,,282.0,,3469,3469,2948,2919,521,550,4310306
4755,87084,3012,3012,2607,2665,405,347,2993.0,,2720.0,,273.0,,2946,2946,2534,2553,412,393,4312385
4756,87092,5488,5488,4662,4697,826,791,5454.0,,4852.0,,602.0,,5437,5437,4709,4676,728,761,4310405
4757,87106,2701,2701,2263,2260,438,441,2706.0,,2421.0,,285.0,,2589,2589,2148,2113,441,476,4312427
4758,87114,6498,6498,4858,4930,1640,1568,6464.0,,5203.0,,1261.0,,6140,6140,4770,4747,1370,1393,4310504
4759,87122,3072,3072,2658,2713,414,359,3079.0,,2925.0,,154.0,,2911,2911,2587,2538,324,373,4312443
4760,87130,27995,27995,19999,20158,7996,7837,27890.0,,19617.0,,8273.0,,27765,27765,20298,19930,7467,7835,4310603
4761,87149,5356,5356,4666,4738,690,618,5245.0,,4450.0,,795.0,,5080,5080,4528,4543,552,537,4312476
4762,87157,3491,3491,2977,3002,514,489,3498.0,,3266.0,,232.0,,3286,3286,2899,2864,387,422,4310702
4763,87165,2107,2107,1743,1782,364,325,2102.0,,1996.0,,106.0,,2095,2095,1691,1674,404,421,4312625
4764,87173,16309,16309,14566,14728,1743,1581,15493.0,,13310.0,,2183.0,,14342,14342,13388,13370,954,972,4310801
4765,87181,2200,2200,1792,1807,408,393,2251.0,,2090.0,,161.0,,1895,1895,1562,1528,333,367,4312674
4766,87190,2930,2930,2497,2567,433,363,2929.0,,2674.0,,255.0,,2958,2958,2586,2573,372,385,4310900
4767,87203,1995,1995,1767,1788,228,207,1985.0,,1885.0,,100.0,,1903,1903,1714,1707,189,196,4312955
4768,87211,20902,20902,16038,16003,4864,4899,20397.0,,14790.0,,5607.0,,20072,20072,16404,16340,3668,3732,4311007
4769,87220,2401,2401,2047,2104,354,297,2350.0,,2092.0,,258.0,,2308,2308,1994,1985,314,323,4313086
4770,87238,8663,8663,7296,7420,1367,1243,8520.0,,7340.0,,1180.0,,8386,8386,7371,7311,1015,1075,4311106
4771,87246,18887,18887,15243,15232,3644,3655,17898.0,,14036.0,,3862.0,,17011,17011,14155,14016,2856,2995,4313375
4772,87254,15114,15114,12341,12463,2773,2651,14822.0,,12284.0,,2538.0,,14491,14491,12465,12333,2026,2158,4311205
4773,87262,3618,3618,3162,3202,456,416,3590.0,,3333.0,,257.0,,3443,3443,2991,2999,452,444,4313490
4774,87270,20195,20195,16649,16856,3546,3339,19849.0,,15877.0,,3972.0,,19644,19644,16970,16771,2674,2873,4311304
4775,87289,3148,3148,2683,2723,465,425,3196.0,,2930.0,,266.0,,3105,3105,2759,2718,346,387,4313425
4776,87297,63378,63378,51941,50213,11437,13165,60950.0,,46618.0,,14332.0,,60191,60191,50466,49637,9725,10554,4311403
4777,87300,1849,1849,1550,1577,299,272,1857.0,,1707.0,,150.0,,1750,1750,1505,1485,245,265,4313441
4778,87319,5480,5480,4512,4486,968,994,5334.0,,4490.0,,844.0,,5280,5280,4495,4399,785,881,4311502
4779,87327,3308,3308,2871,2880,437,428,3239.0,,2887.0,,352.0,,3043,3043,2693,2666,350,377,4314035
4780,87335,4418,4418,3589,3621,829,797,4382.0,,3940.0,,442.0,,4410,4410,3654,3645,756,765,4311601
4781,87343,4968,4968,4369,4379,599,589,4904.0,,4490.0,,414.0,,4800,4800,4299,4249,501,551,4314076
4782,87351,4680,4680,3994,4108,686,572,4619.0,,4184.0,,435.0,,4487,4487,3974,3941,513,546,4311700
4783,87360,4466,4466,3815,3812,651,654,4428.0,,3814.0,,614.0,,4357,4357,3808,3767,549,590,4314423
4784,87378,31963,31963,26593,26970,5370,4993,31235.0,,25378.0,,5857.0,,30977,30977,25983,25780,4994,5197,4311809
4785,87386,3598,3598,2938,2982,660,616,3590.0,,3255.0,,335.0,,3515,3515,2950,2910,565,605,4314472
4786,87394,3846,3846,3247,3304,599,542,3827.0,,3436.0,,391.0,,3826,3826,3374,3343,452,483,4311908
4787,87408,3670,3670,3146,3111,524,559,3624.0,,3395.0,,229.0,,3237,3237,2922,2894,315,343,4314498
4788,87416,2158,2158,1814,1859,344,299,2175.0,,2076.0,,99.0,,2016,2016,1743,1693,273,323,4312005
4789,87424,3338,3338,2842,2910,496,428,3255.0,,2991.0,,264.0,,3086,3086,2692,2733,394,353,4314779
4790,87432,4070,4070,3279,3325,791,745,4051.0,,3354.0,,697.0,,4066,4066,3351,3319,715,747,4312104
4791,87440,1785,1785,1580,1589,205,196,1790.0,,1716.0,,74.0,,1684,1684,1499,1497,185,187,4314787
4792,87459,4014,4014,3317,3394,697,620,3974.0,,3628.0,,346.0,,3965,3965,3378,3326,587,639,4312203
4793,87467,2253,2253,1884,1909,369,344,2247.0,,2016.0,,231.0,,2172,2172,1839,1789,333,383,4315057
4794,87475,4199,4199,3564,3547,635,652,4070.0,,3687.0,,383.0,,3893,3893,3303,3295,590,598,4312302
4795,87483,1696,1696,1414,1426,282,270,1660.0,,1495.0,,165.0,,1632,1632,1358,1367,274,265,4315073
4796,87491,48461,48461,38080,37691,10381,10770,47499.0,,34665.0,,12834.0,,47189,47189,37413,37147,9776,10042,4312401
4797,87505,2520,2520,2273,2300,247,220,2474.0,,2299.0,,175.0,,2366,2366,2182,2164,184,202,4315149
4798,87513,8938,8938,7100,7192,1838,1746,8636.0,,7202.0,,1434.0,,8321,8321,7063,6943,1258,1378,4312500
4799,87521,2343,2343,1911,1924,432,419,2358.0,,2186.0,,172.0,,2173,2173,1808,1775,365,398,4315321
4800,87530,4123,4123,3512,3526,611,597,4160.0,,3733.0,,427.0,,3999,3999,3509,3467,490,532,4312609
4801,87548,2912,2912,2355,2361,557,551,2917.0,,2592.0,,325.0,,2883,2883,2359,2327,524,556,4315552
4802,87556,13147,13147,11195,11172,1952,1975,12784.0,,10854.0,,1930.0,,12398,12398,10985,10932,1413,1466,4312658
4803,87564,2253,2253,1865,1887,388,366,2270.0,,2053.0,,217.0,,2194,2194,1809,1771,385,423,4316428
4804,87572,9480,9480,7660,7791,1820,1689,9205.0,,7929.0,,1276.0,,9042,9042,7494,7423,1548,1619,4312708
4805,87580,2621,2621,2308,2314,313,307,2615.0,,2451.0,,164.0,,2445,2445,2167,2144,278,301,4316477
4806,87599,3999,3999,3317,3369,682,630,3948.0,,3431.0,,517.0,,3879,3879,3360,3355,519,524,4312807
4807,87602,5346,5346,4631,4563,715,783,5219.0,,4723.0,,496.0,,5022,5022,4510,4467,512,555,4316758
4808,87610,7109,7109,6211,6337,898,772,6957.0,,6327.0,,630.0,,6844,6844,6162,6142,682,702,4312906
4809,87629,1725,1725,1505,1502,220,223,1713.0,,1561.0,,152.0,,1663,1663,1428,1407,235,256,4317251
4810,87637,2728,2728,2341,2395,387,333,2686.0,,2519.0,,167.0,,2642,2642,2363,2329,279,313,4313003
4811,87645,1925,1925,1662,1689,263,236,1899.0,,1772.0,,127.0,,1891,1891,1625,1627,266,264,4317558
4812,87653,5181,5181,4384,4447,797,734,5138.0,,4539.0,,599.0,,5149,5149,4480,4466,669,683,4313102
4813,87661,2039,2039,1784,1787,255,252,2043.0,,1893.0,,150.0,,1934,1934,1687,1677,247,257,4317756
4814,87670,17105,17105,14538,14434,2567,2671,16379.0,,13534.0,,2845.0,,15540,15540,14014,13887,1526,1653,4313201
4815,87688,2212,2212,1895,1934,317,278,2180.0,,2043.0,,137.0,,2172,2172,1862,1865,310,307,4317954
4816,87696,18469,18469,15946,16107,2523,2362,17872.0,,15428.0,,2444.0,,17265,17265,15727,15602,1538,1663,4313300
4817,87700,2572,2572,2103,2114,469,458,2542.0,,2090.0,,452.0,,2526,2526,2095,2063,431,463,4318432
4818,87718,180479,180479,144280,145523,36199,34956,177990.0,,126445.0,,51545.0,,180249,180249,146677,145352,33572,34897,4313409
4819,87726,3124,3124,2426,2451,698,673,3147.0,,2527.0,,620.0,,2904,2904,2361,2300,543,604,4318622
4820,87734,37291,37291,29398,29641,7893,7650,36252.0,,26259.0,,9993.0,,36300,36300,28949,28718,7351,7582,4313508
4821,87742,2224,2224,1956,1977,268,247,2195.0,,2063.0,,132.0,,2139,2139,1937,1930,202,209,4318499
4822,87750,3851,3851,3250,3334,601,517,3867.0,,3571.0,,296.0,,3759,3759,3174,3140,585,619,4313607
4823,87769,2197,2197,1853,1873,344,324,2189.0,,2045.0,,144.0,,2102,2102,1734,1727,368,375,4318457
4824,87777,24079,24079,19935,20176,4144,3903,23221.0,,18867.0,,4354.0,,22267,22267,19258,19165,3009,3102,4313706
4825,87785,3086,3086,2464,2506,622,580,3119.0,,2735.0,,384.0,,2954,2954,2412,2375,542,579,4319125
4826,87793,5922,5922,5105,5140,817,782,5749.0,,5255.0,,494.0,,5633,5633,4988,4935,645,698,4313805
4827,87807,3131,3131,2774,2818,357,313,3089.0,,2830.0,,259.0,,2932,2932,2675,2683,257,249,4319356
4828,87815,31871,31871,26570,27062,5301,4809,31082.0,,25189.0,,5893.0,,30104,30104,26186,26028,3918,4076,4313904
4829,87823,2544,2544,2224,2248,320,296,2492.0,,2351.0,,141.0,,2312,2312,2081,2053,231,259,4319372
4830,87831,6130,6130,5219,5325,911,805,6121.0,,5444.0,,677.0,,6204,6204,5317,5292,887,912,4314001
4831,87840,2213,2213,1857,1885,356,328,2222.0,,1964.0,,258.0,,2113,2113,1814,1802,299,311,4319711
4832,87858,149799,149799,120648,121935,29151,27864,146664.0,,109327.0,,37337.0,,146094,146094,119079,118146,27015,27948,4314100
4833,87866,2264,2264,1787,1809,477,455,2307.0,,2096.0,,211.0,,2103,2103,1769,1680,334,423,4319737
4834,87874,6990,6990,5446,5390,1544,1600,6881.0,,5298.0,,1583.0,,6783,6783,5318,5263,1465,1520,4314209
4835,87882,4202,4202,3403,3419,799,783,4124.0,,3473.0,,651.0,,3978,3978,3376,3342,602,636,4320354
4836,87890,3102,3102,2631,2662,471,440,3042.0,,2684.0,,358.0,,2969,2969,2583,2529,386,440,4314308
4837,87904,2007,2007,1726,1722,281,285,2000.0,,1893.0,,107.0,,1967,1967,1742,1730,225,237,4320453
4838,87912,247744,247744,201978,202603,45766,45141,240948.0,240948.0,176916.0,170162.0,64032.0,70786.0,238487,238487,201531,201385,36956,37102,4314407
4839,87920,5337,5337,4349,4428,988,909,5244.0,,4556.0,,688.0,,5023,5023,4268,4220,755,803,4320552
4840,87939,10157,10157,7688,7686,2469,2471,10140.0,,7791.0,,2349.0,,10230,10230,8183,8177,2047,2053,4314506
4841,87947,6806,6806,6051,5987,755,819,6715.0,,6243.0,,472.0,,6440,6440,6051,5965,389,475,4320677
4842,87955,14809,14809,11915,12016,2894,2793,14505.0,,11940.0,,2565.0,,14237,14237,11890,11906,2347,2331,4314605
4843,87963,4589,4589,3711,3704,878,885,4553.0,,3976.0,,577.0,,4531,4531,3828,3817,703,714,4321477
4844,87971,8035,8035,6461,6518,1574,1517,7856.0,,6576.0,,1280.0,,7590,7590,6242,6304,1348,1286,4314704
4845,87980,1960,1960,1725,1731,235,229,1929.0,,1818.0,,111.0,,1893,1893,1722,1702,171,191,4321626
4846,87998,25431,25431,20905,21026,4526,4405,25094.0,,20068.0,,5026.0,,23756,23756,19716,19423,4040,4333,4314803
4847,88005,2875,2875,2392,2418,483,457,2901.0,,2723.0,,178.0,,2609,2609,2224,2198,385,411,4321832
4848,88013,1103600,1103600,855346,857708,248254,245892,1082726.0,1082726.0,724509.0,728034.0,358217.0,354692.0,1100163,1100163,855056,849817,245107,250346,4314902
4849,88021,1463,1463,1212,1242,251,221,1477.0,,1365.0,,112.0,,1408,1408,1121,1106,287,302,4322186
4850,88030,3936,3936,3241,3271,695,665,3920.0,,3407.0,,513.0,,3914,3914,3376,3362,538,552,4315008
4851,88048,1510,1510,1285,1314,225,196,1503.0,,1406.0,,97.0,,1465,1465,1273,1268,192,197,4322350
4852,88056,7738,7738,6538,6575,1200,1163,7633.0,,6674.0,,959.0,,7426,7426,6344,6348,1082,1078,4315107
4853,88064,8242,8242,7079,7100,1163,1142,8140.0,,7144.0,,996.0,,8152,8152,7166,7171,986,981,4322533
4854,88072,3887,3887,3020,3084,867,803,3852.0,,3476.0,,376.0,,3933,3933,3009,3001,924,932,4315206
4855,88080,4818,4818,4093,4151,725,667,4697.0,,4106.0,,591.0,,4570,4570,4057,4012,513,558,4322541
4856,88099,17725,17725,13713,13849,4012,3876,17095.0,,13211.0,,3884.0,,16768,16768,13829,13525,2939,3243,4315305
4857,88102,3792,3792,2962,3025,830,767,3809.0,,3321.0,,488.0,,3518,3518,2842,2783,676,735,4323457
4858,88110,6754,6754,5176,5123,1578,1631,6620.0,,5625.0,,995.0,,6233,6233,4991,4969,1242,1264,4315404
4859,88129,3339,3339,2757,2816,582,523,3353.0,,3066.0,,287.0,,3296,3296,2761,2753,535,543,4323754
4860,88137,12434,12434,10310,10300,2124,2134,12169.0,,10041.0,,2128.0,,11779,11779,10360,10193,1419,1586,4315503
4861,88145,12302,12302,9918,10126,2384,2176,11204.0,,9078.0,,2126.0,,10104,10104,8514,8461,1590,1643,4323804
4862,88153,155633,155633,117816,117982,37817,37651,154247.0,,108385.0,,45862.0,,156227,156227,120016,119785,36211,36442,4315602
4863,88161,2496,2496,2095,2136,401,360,2474.0,,2260.0,,214.0,,2448,2448,2160,2152,288,296,4302253
4864,88170,29838,29838,23202,23126,6636,6712,29827.0,,22776.0,,7051.0,,30465,30465,23858,23405,6607,7060,4315701
4865,88188,3071,3071,2456,2458,615,613,3085.0,,2669.0,,416.0,,2799,2799,2292,2216,507,583,4306379
4866,88196,7740,7740,6751,6672,989,1068,7513.0,,6781.0,,732.0,,7116,7116,6554,6515,562,601,4315800
4867,88200,3709,3709,3025,3018,684,691,3632.0,,2912.0,,720.0,,3482,3482,2952,2872,530,610,4304671
4868,88218,5103,5103,4360,4416,743,687,4885.0,,4326.0,,559.0,,4779,4779,4133,4088,646,691,4315909
4869,88226,2536,2536,2307,2322,229,214,2433.0,,2312.0,,121.0,,2344,2344,2191,2198,153,146,4313011
4870,88234,16233,16233,13913,14082,2320,2151,15663.0,,13595.0,,2068.0,,15129,15129,13395,13335,1734,1794,4316006
4871,88242,1881,1881,1544,1580,337,301,1905.0,,1782.0,,123.0,,1814,1814,1547,1543,267,271,4308250
4872,88250,7325,7325,6284,6378,1041,947,7322.0,,6559.0,,763.0,,7078,7078,6183,6199,895,879,4316105
4873,88269,4235,4235,3691,3693,544,542,4108.0,,3656.0,,452.0,,4050,4050,3584,3551,466,499,4305447
4874,88277,4624,4624,3968,4043,656,581,4669.0,,4070.0,,599.0,,4659,4659,4031,4037,628,622,4316204
4875,88285,3015,3015,2562,2512,453,503,2933.0,,2635.0,,298.0,,2730,2730,2387,2368,343,362,4307450
4876,88293,5397,5397,4650,4659,747,738,5314.0,,4805.0,,509.0,,5203,5203,4645,4630,558,573,4316303
4877,88307,2096,2096,1717,1778,379,318,2120.0,,1964.0,,156.0,,1965,1965,1670,1649,295,316,4306759
4878,88315,32189,32189,23793,23826,8396,8363,32099.0,,22364.0,,9735.0,,32418,32418,23821,23434,8597,8984,4316402
4879,88323,2548,2548,2139,2135,409,413,2575.0,,2418.0,,157.0,,2448,2448,2148,2074,300,374,4309571
4880,88331,5479,5479,4811,4837,668,642,5317.0,,4802.0,,515.0,,5176,5176,4766,4758,410,418,4316501
4881,88340,6413,6413,5009,5076,1404,1337,6253.0,,5179.0,,1074.0,,6087,6087,4947,4885,1140,1202,4304713
4882,88358,13273,13273,11178,11444,2095,1829,13031.0,,11057.0,,1974.0,,13024,13024,11044,11076,1980,1948,4316600
4883,88366,3457,3457,2905,2884,552,573,3392.0,,3008.0,,384.0,,3192,3192,2768,2720,424,472,4308078
4884,88374,6962,6962,5737,5853,1225,1109,6962.0,,5676.0,,1286.0,,6980,6980,5894,5834,1086,1146,4316709
4885,88382,4271,4271,3558,3598,713,673,4105.0,,3403.0,,702.0,,3915,3915,3336,3312,579,603,4310538
4886,88390,105317,105317,86240,86518,19077,18799,103396.0,,80896.0,,22500.0,,102520,102520,85976,84973,16544,17547,4316808
4887,88404,2936,2936,2493,2498,443,438,2943.0,,2778.0,,165.0,,2920,2920,2467,2457,453,463,4307815
4888,88412,208727,208727,164861,165521,43866,43206,204282.0,204282.0,145406.0,140266.0,58876.0,64016.0,206116,206116,163472,162169,42644,43947,4316907
4889,88420,2080,2080,1688,1720,392,360,2071.0,,1945.0,,126.0,,1939,1939,1541,1600,398,339,4302055
4890,88439,6454,6454,5098,5086,1356,1368,6480.0,,5429.0,,1051.0,,6204,6204,5096,5002,1108,1202,4317004
4891,88447,3959,3959,3056,3037,903,922,3979.0,,3367.0,,612.0,,3715,3715,2907,2785,808,930,4311718
4892,88455,73905,73905,52353,52355,21552,21550,73165.0,,48879.0,,24286.0,,73748,73748,53360,52820,20388,20928,4317103
4893,88463,2449,2449,2118,2124,331,325,2418.0,,2219.0,,199.0,,2389,2389,2099,2063,290,326,4306551
4894,88471,57869,57869,47667,47337,10202,10532,57295.0,,45916.0,,11379.0,,57102,57102,47161,46504,9941,10598,4317202
4895,88480,2643,2643,2129,2114,514,529,2599.0,,2278.0,,321.0,,2541,2541,2059,2006,482,535,4322376
4896,88498,24655,24655,17922,17535,6733,7120,24586.0,,17271.0,,7315.0,,24818,24818,17729,17592,7089,7226,4317301
4897,88501,3402,3402,2787,2775,615,627,3351.0,,2889.0,,462.0,,3298,3298,2847,2804,451,494,4322327
4898,88510,41107,41107,31202,31448,9905,9659,40316.0,,28802.0,,11514.0,,40251,40251,31186,30565,9065,9686,4317400
4899,88528,2502,2502,2133,2153,369,349,2481.0,,2271.0,,210.0,,2416,2416,2064,2065,352,351,4306072
4900,88536,61206,61206,47303,47731,13903,13475,61133.0,,44023.0,,17110.0,,61833,61833,48031,47581,13802,14252,4317509
4901,88544,2723,2723,2189,2205,534,518,2757.0,,2442.0,,315.0,,2441,2441,1974,1941,467,500,4312617
4902,88552,34058,34058,26764,27074,7294,6984,33638.0,,25299.0,,8339.0,,33513,33513,26528,26226,6985,7287,4317608
4903,88560,2030,2030,1741,1773,289,257,2046.0,,1857.0,,189.0,,2026,2026,1749,1763,277,263,4313334
4904,88579,8674,8674,6852,6857,1822,1817,8664.0,,6715.0,,1949.0,,8620,8620,6837,6709,1783,1911,4317707
4905,88587,2826,2826,2367,2396,459,430,2849.0,,2553.0,,296.0,,2887,2887,2452,2417,435,470,4311130
4906,88595,11248,11248,9221,9360,2027,1888,11059.0,,8994.0,,2065.0,,10996,10996,9159,9055,1837,1941,4317806
4907,88609,1868,1868,1654,1661,214,207,1878.0,,1757.0,,121.0,,1854,1854,1670,1667,184,187,4322343
4908,88617,12960,12960,11078,11124,1882,1836,12767.0,,10868.0,,1899.0,,12898,12898,10997,10904,1901,1994,4317905
4909,88625,3081,3081,2351,2287,730,794,2987.0,,2486.0,,501.0,,2783,2783,2147,2077,636,706,4301875
4910,88633,48635,48635,36424,36713,12211,11922,48536.0,,34788.0,,13748.0,,48585,48585,35684,35220,12901,13365,4318002
4911,88641,5478,5478,4394,4420,1084,1058,5420.0,,4402.0,,1018.0,,5418,5418,4509,4475,909,943,4305124
4912,88650,14542,14542,11840,11932,2702,2610,14359.0,,11649.0,,2710.0,,14086,14086,12147,11855,1939,2231,4318101
4913,88668,3098,3098,2550,2542,548,556,3121.0,,2756.0,,365.0,,2993,2993,2499,2454,494,539,4322525
4914,88676,15648,15648,12811,12913,2837,2735,15158.0,,12342.0,,2816.0,,14416,14416,12496,12295,1920,2121,4318200
4915,88684,3666,3666,3093,3063,573,603,3659.0,,3329.0,,330.0,,3484,3484,3035,2979,449,505,4313391
4916,88692,45795,45795,34294,34494,11501,11301,46248.0,,33717.0,,12531.0,,46893,46893,34947,34256,11946,12637,4318309
4917,88706,1798,1798,1540,1552,258,246,1782.0,,1662.0,,120.0,,1726,1726,1533,1525,193,201,4320578
4918,88714,15457,15457,12748,12739,2709,2718,14855.0,,12291.0,,2564.0,,13732,13732,12201,12018,1531,1714,4318408
4919,88722,3863,3863,3262,3266,601,597,3859.0,,3468.0,,391.0,,3671,3671,3151,3112,520,559,4320859
4920,88730,20418,20418,16778,16769,3640,3649,19867.0,,16260.0,,3607.0,,19517,19517,16840,16621,2677,2896,4318507
4921,88749,2137,2137,1870,1931,267,206,2147.0,,2004.0,,143.0,,2131,2131,1872,1869,259,262,4323358
4922,88757,5778,5778,4969,5099,809,679,5685.0,,4898.0,,787.0,,5656,5656,4868,4893,788,763,4318606
4923,88765,2620,2620,2291,2299,329,321,2619.0,,2408.0,,211.0,,2597,2597,2294,2280,303,317,4320321
4924,88773,167713,167713,131788,132574,35925,35139,164220.0,,112914.0,,51306.0,,166292,166292,132835,131375,33457,34917,4318705
4925,88781,2242,2242,1898,1941,344,301,2241.0,,2151.0,,90.0,,2175,2175,1848,1842,327,333,4322855
4926,88790,35961,35961,28385,28578,7576,7383,35682.0,,27153.0,,8529.0,,35985,35985,28706,28774,7279,7211,4318804
4927,88803,3262,3262,2490,2623,772,639,3276.0,,2840.0,,436.0,,3276,3276,2554,2506,722,770,4312377
4928,88811,27018,27018,20407,20594,6611,6424,26897.0,,19170.0,,7727.0,,27204,27204,20315,20038,6889,7166,4318903
4929,88820,3484,3484,2917,2899,567,585,3419.0,,3035.0,,384.0,,3411,3411,2934,2917,477,494,4312054
4930,88838,16155,16155,14061,14177,2094,1978,15685.0,,13362.0,,2323.0,,15108,15108,13775,13679,1333,1429,4319000
4931,88846,4569,4569,3345,3245,1224,1324,4330.0,,3308.0,,1022.0,,3945,3945,3065,3038,880,907,4305439
4932,88854,4870,4870,4203,4226,667,644,4758.0,,4292.0,,466.0,,4766,4766,4150,4120,616,646,4319109
4933,88862,5753,5753,4752,4849,1001,904,5653.0,,4869.0,,784.0,,4987,4987,4270,4226,717,761,4300877
4934,88870,4098,4098,3360,3353,738,745,4009.0,,3587.0,,422.0,,3743,3743,3248,3208,495,535,4319208
4935,88889,3767,3767,3170,3179,597,588,3728.0,,3381.0,,347.0,,3678,3678,3262,3213,416,465,4314068
4936,88897,5230,5230,4414,4415,816,815,5176.0,,4516.0,,660.0,,5211,5211,4519,4458,692,753,4319307
4937,88900,2677,2677,2286,2297,391,380,2676.0,,2443.0,,233.0,,2578,2578,2243,2199,335,379,4321493
4938,88919,12779,12779,10512,10651,2267,2128,12449.0,,10229.0,,2220.0,,12366,12366,10756,10609,1610,1757,4319406
4939,88927,9859,9859,7178,7195,2681,2664,9395.0,,7267.0,,2128.0,,8074,8074,6277,6142,1797,1932,4301636
4940,88935,17151,17151,14484,14585,2667,2566,16595.0,,13834.0,,2761.0,,15341,15341,13752,13683,1589,1658,4319505
4941,88943,2859,2859,2428,2442,431,417,2849.0,,2711.0,,138.0,,2666,2666,2331,2281,335,385,4311734
4942,88951,17079,17079,13972,14051,3107,3028,16791.0,,13669.0,,3122.0,,16281,16281,14168,13923,2113,2358,4319604
4943,88978,3097,3097,2617,2671,480,426,3095.0,,2824.0,,271.0,,3048,3048,2592,2587,456,461,4319703
4944,88986,3839,3839,3045,3064,794,775,3757.0,,2955.0,,802.0,,3655,3655,3030,2976,625,679,4300034
4945,88994,62252,62252,51240,51753,11012,10499,61555.0,,49023.0,,12532.0,,61211,61211,51206,50526,10005,10685,4319901
4946,89001,1894,1894,1669,1671,225,223,1906.0,,1771.0,,135.0,,1881,1881,1644,1627,237,254,4300471
4947,89010,105557,105557,81964,82334,23593,23223,103934.0,,71907.0,,32027.0,,105070,105070,82932,82138,22138,22932,4320008
4948,89028,2698,2698,2385,2396,313,302,2648.0,,2417.0,,231.0,,2642,2642,2416,2392,226,250,4301073
4949,89036,16768,16768,14273,14452,2495,2316,16077.0,,14218.0,,1859.0,,15463,15463,13499,13385,1964,2078,4320107
4950,89044,2099,2099,1746,1756,353,343,2066.0,,1872.0,,194.0,,1983,1983,1661,1642,322,341,4302220
4951,89052,9027,9027,7697,7776,1330,1251,8659.0,,7698.0,,961.0,,8387,8387,7447,7377,940,1010,4320206
4952,89060,2139,2139,1870,1869,269,270,2135.0,,1955.0,,180.0,,2072,2072,1791,1734,281,338,4302238
4953,89079,4394,4394,3742,3829,652,565,4382.0,,3898.0,,484.0,,4325,4325,3734,3673,591,652,4320305
4954,89087,2368,2368,2054,2084,314,284,2362.0,,2188.0,,174.0,,2307,2307,2008,1974,299,333,4302584
4955,89095,12544,12544,10678,10860,1866,1684,12202.0,,10600.0,,1602.0,,11925,11925,10366,10379,1559,1546,4320404
4956,89109,1821,1821,1628,1603,193,218,1805.0,,1729.0,,76.0,,1765,1765,1542,1531,223,234,4304614
4957,89117,4910,4910,4254,4297,656,613,4841.0,,4412.0,,429.0,,4723,4723,4250,4225,473,498,4320503
4958,89125,2038,2038,1713,1707,325,331,2039.0,,1828.0,,211.0,,1952,1952,1636,1604,316,348,4304622
4959,89133,3447,3447,2917,2953,530,494,3459.0,,3022.0,,437.0,,3417,3417,2962,2933,455,484,4320602
4960,89141,2893,2893,2334,2372,559,521,2792.0,,2494.0,,298.0,,2705,2705,2230,2182,475,523,4304655
4961,89150,42362,42362,32607,33099,9755,9263,39491.0,,28201.0,,11290.0,,37401,37401,29019,28785,8382,8616,4304630
4962,89168,1383,1383,1160,1166,223,217,1398.0,,1287.0,,111.0,,1325,1325,1107,1098,218,227,4305835
4963,89176,11433,11433,9094,9145,2339,2288,11495.0,,9285.0,,2210.0,,11686,11686,9375,9244,2311,2442,4320701
4964,89184,1512,1512,1269,1297,243,215,1472.0,,1352.0,,120.0,,1442,1442,1245,1242,197,200,4305934
4965,89192,21564,21564,18068,18239,3496,3325,20884.0,,17641.0,,3243.0,,20286,20286,17945,17626,2341,2660,4320800
4966,89206,1988,1988,1724,1747,264,241,2025.0,,1868.0,,157.0,,1979,1979,1757,1747,222,232,4306130
4967,89214,17087,17087,14545,14896,2542,2191,16577.0,,14134.0,,2443.0,,16059,16059,14038,13978,2021,2081,4320909
4968,89222,2384,2384,2096,2086,288,298,2404.0,,2255.0,,149.0,,2286,2286,2041,2014,245,272,4308433
4969,89230,7991,7991,6793,6891,1198,1100,7881.0,,6664.0,,1217.0,,7729,7729,6747,6696,982,1033,4321006
4970,89247,1822,1822,1570,1611,252,211,1786.0,,1689.0,,97.0,,1747,1747,1546,1527,201,220,4316733
4971,89249,3284,3284,2694,2738,590,546,3267.0,,2980.0,,287.0,,2663,2663,2237,2195,426,468,4310652
4972,89257,11456,11456,9194,9210,2262,2246,11090.0,,8954.0,,2136.0,,10440,10440,9109,8990,1331,1450,4321105
4973,89265,1968,1968,1691,1685,277,283,1966.0,,1849.0,,117.0,,1974,1974,1711,1681,263,293,4310876
4974,89273,41995,41995,33468,33695,8527,8300,41351.0,,31068.0,,10283.0,,41633,41633,33476,33075,8157,8558,4321204
4975,89281,2337,2337,1920,1956,417,381,2324.0,,2170.0,,154.0,,2247,2247,1931,1925,316,322,4311239
4976,89290,19491,19491,16334,16270,3157,3221,19301.0,,15646.0,,3655.0,,18856,18856,16515,16343,2341,2513,4321303
4977,89303,1617,1617,1347,1375,270,242,1618.0,,1446.0,,172.0,,1573,1573,1344,1330,229,243,4312179
4978,89311,10430,10430,8627,8631,1803,1799,9927.0,,8483.0,,1444.0,,9301,9301,8052,8011,1249,1290,4321402
4979,89320,1592,1592,1337,1367,255,225,1601.0,,1481.0,,120.0,,1559,1559,1327,1314,232,245,4313466
4980,89338,31518,31518,24334,24746,7184,6772,29836.0,,21726.0,,8110.0,,29289,29289,22613,22468,6676,6821,4321501
4981,89346,2053,2053,1833,1852,220,201,2044.0,,1878.0,,166.0,,1892,1892,1706,1697,186,195,4314134
4982,89354,37402,37402,27381,27558,10021,9844,35890.0,,24268.0,,11622.0,,35253,35253,25823,25416,9430,9837,4321600
4983,89362,2486,2486,1921,1969,565,517,2494.0,,2268.0,,226.0,,2375,2375,1813,1794,562,581,4314464
4984,89370,17519,17519,14903,14979,2616,2540,17352.0,,14339.0,,3013.0,,16971,16971,15086,15023,1885,1948,4321709
4985,89389,1636,1636,1410,1433,226,203,1667.0,,1601.0,,66.0,,1518,1518,1319,1276,199,242,4315313
4986,89397,17936,17936,15441,15342,2495,2594,17671.0,,15256.0,,2415.0,,16944,16944,15413,15240,1531,1704,4321808
4987,89400,2350,2350,1961,1972,389,378,2329.0,,2165.0,,164.0,,2159,2159,1831,1816,328,343,4315958
4988,89419,18465,18465,15694,15818,2771,2647,17699.0,,15046.0,,2653.0,,17394,17394,15518,15367,1876,2027,4321907
4989,89435,21982,21982,17593,17800,4389,4182,21403.0,,17680.0,,3723.0,,21217,21217,17425,17196,3792,4021,4322004
4990,89443,2634,2634,2172,2152,462,482,2662.0,,2343.0,,319.0,,2531,2531,2090,2011,441,520,4316972
4991,89451,4763,4763,4051,4070,712,693,4760.0,,4175.0,,585.0,,4692,4692,4042,3997,650,695,4322103
4992,89460,1952,1952,1741,1744,211,208,1909.0,,1786.0,,123.0,,1805,1805,1638,1637,167,168,4318614
4993,89478,16321,16321,13043,13222,3278,3099,16019.0,,12534.0,,3485.0,,15960,15960,13085,12931,2875,3029,4322202
4994,89486,1589,1589,1322,1324,267,265,1578.0,,1440.0,,138.0,,1516,1516,1286,1284,230,232,4319364
4995,89494,7120,7120,5948,6040,1172,1080,7087.0,,5983.0,,1104.0,,7061,7061,6089,6017,972,1044,4322301
4996,89508,2531,2531,2199,2192,332,339,2435.0,,2245.0,,190.0,,2323,2323,2050,2035,273,288,4321469
4997,89516,88062,88062,63395,63925,24667,24137,86580.0,,57925.0,,28655.0,,88820,88820,64529,63575,24291,25245,4322400
4998,89524,2605,2605,2284,2256,321,349,2561.0,,2337.0,,224.0,,2549,2549,2266,2226,283,323,4323770
4999,89532,47324,47324,36844,37628,10480,9696,46665.0,,35626.0,,11039.0,,46880,46880,37009,36716,9871,10164,4322509
5000,89540,2406,2406,2040,2083,366,323,2333.0,,2061.0,,272.0,,2311,2311,1981,1969,330,342,4314548
5001,89559,53567,53567,44615,44731,8952,8836,52393.0,,43354.0,,9039.0,,51103,51103,44429,44041,6674,7062,4322608
5002,89567,2009,2009,1572,1567,437,442,2016.0,,1730.0,,286.0,,1938,1938,1509,1508,429,430,4314175
5003,89575,18558,18558,16675,16706,1883,1852,17911.0,,16191.0,,1720.0,,16990,16990,15973,15903,1017,1087,4322707
5004,89591,18173,18173,15712,15903,2461,2270,17540.0,,14875.0,,2665.0,,17037,17037,15525,15458,1512,1579,4322806
5005,89613,4171,4171,3591,3652,580,519,4166.0,,3801.0,,365.0,,4150,4150,3652,3669,498,481,4322905
5006,89630,162815,162815,130439,130223,32376,32592,155816.0,,114335.0,,41481.0,,148618,148618,127214,126238,21404,22380,4323002
5007,89656,3798,3798,3119,3148,679,650,3780.0,,3384.0,,396.0,,3728,3728,3234,3214,494,514,4323101
5008,89672,10893,10893,8193,8279,2700,2614,10386.0,,7548.0,,2838.0,,10336,10336,7994,7830,2342,2506,4313656
5009,89699,2511,2511,2127,2133,384,378,2496.0,,2259.0,,237.0,,2433,2433,2132,2101,301,332,4323200
5010,89710,4546,4546,3609,3612,937,934,4533.0,,3950.0,,583.0,,4435,4435,3561,3522,874,913,4321352
5011,89737,17897,17897,14787,14808,3110,3089,17164.0,,13705.0,,3459.0,,16270,16270,14233,14171,2037,2099,4304663
5012,89753,8018,8018,6484,6522,1534,1496,7929.0,,6734.0,,1195.0,,7762,7762,6651,6563,1111,1199,4316451
5013,89770,3508,3508,3002,3078,506,430,3465.0,,3147.0,,318.0,,3404,3404,3021,2999,383,405,4305959
5014,89788,17708,17708,12446,12714,5262,4994,16967.0,,12019.0,,4948.0,,17207,17207,11864,11615,5343,5592,5103254
5015,89796,24047,24047,18042,18524,6005,5523,23859.0,,17563.0,,6296.0,,23244,23244,16860,16573,6384,6671,5103205
5016,89800,4334,4334,3393,3377,941,957,4343.0,,3562.0,,781.0,,3923,3923,2973,2864,950,1059,5103437
5017,89818,3677,3677,2791,2773,886,904,3612.0,,2995.0,,617.0,,3299,3299,2555,2472,744,827,5106208
5018,89826,2930,2930,2270,2262,660,668,2828.0,,2387.0,,441.0,,2582,2582,2058,1982,524,600,5106190
5019,89834,15675,15675,11220,11385,4455,4290,14979.0,,10802.0,,4177.0,,14827,14827,10427,9879,4400,4948,5106307
5020,89843,2641,2641,1828,1819,813,822,2661.0,,2077.0,,584.0,,2423,2423,1598,1552,825,871,5107792
5021,89850,106940,106940,81652,85115,25288,21825,97934.0,,70103.0,,27831.0,,86946,86946,71049,71275,15897,15671,5107909
5022,89877,41569,41569,30793,32114,10776,9455,39910.0,,29138.0,,10772.0,,38667,38667,28005,27603,10662,11064,5100250
5023,89893,12049,12049,8762,8973,3287,3076,11930.0,,8759.0,,3171.0,,11916,11916,8681,8519,3235,3397,5101258
5024,89915,7649,7649,5045,5126,2604,2523,7686.0,,5398.0,,2288.0,,8059,8059,5444,5308,2615,2751,5105002
5025,89931,14277,14277,10281,10553,3996,3724,14294.0,,10012.0,,4282.0,,14335,14335,10100,9972,4235,4363,5107107
5026,89958,3976,3976,3029,3018,947,958,3893.0,,3109.0,,784.0,,4031,4031,2964,2905,1067,1126,5107206
5027,89960,2753,2753,1903,1874,850,879,2628.0,,2008.0,,620.0,,2465,2465,1620,1581,845,884,5107578
5028,89974,2923,2923,2278,2293,645,630,2929.0,,2396.0,,533.0,,2973,2973,2302,2242,671,731,5107750
5029,89990,32235,32235,23483,23888,8752,8347,30438.0,,21990.0,,8448.0,,29437,29437,22382,21991,7055,7446,5106752
5030,90018,6640,6640,5555,5274,1085,1366,6184.0,,5372.0,,812.0,,5986,5986,4976,4581,1010,1405,5100102
5031,90026,2771,2771,2114,2125,657,646,2767.0,,2134.0,,633.0,,2921,2921,2149,2101,772,820,5107297
5032,90034,12244,12244,8353,8214,3891,4030,11913.0,,8818.0,,3095.0,,11616,11616,7561,7282,4055,4334,5000203
5033,90042,4139,4139,2938,2962,1201,1177,4187.0,,3268.0,,919.0,,3605,3605,2547,2395,1058,1210,5100359
5034,90050,12287,12287,9011,9056,3276,3231,12014.0,,9163.0,,2851.0,,12160,12160,8571,8173,3589,3987,5100300
5035,90069,15046,15046,10774,10716,4272,4330,13746.0,,9542.0,,4204.0,,12073,12073,8482,8174,3591,3899,5107065
5036,90077,8274,8274,6230,6319,2044,1955,8307.0,,6536.0,,1771.0,,7323,7323,5226,5217,2097,2106,5100409
5037,90085,3697,3697,2603,2618,1094,1079,3639.0,,2805.0,,834.0,,3791,3791,2575,2488,1216,1303,5102694
5038,90093,6124,6124,4642,4580,1482,1544,6075.0,,4957.0,,1118.0,,6242,6242,4676,4339,1566,1903,5100508
5039,90107,3700,3700,2882,2949,818,751,3594.0,,2895.0,,699.0,,3398,3398,2618,2551,780,847,5107248
5040,90115,26348,26348,20048,20107,6300,6241,25895.0,,19144.0,,6751.0,,25222,25222,19082,18589,6140,6633,5000609
5041,90123,4275,4275,3033,3074,1242,1201,3961.0,,3017.0,,944.0,,4083,4083,2710,2590,1373,1493,5108907
5042,90131,18204,18204,13571,13395,4633,4809,17976.0,,13631.0,,4345.0,,18198,18198,13295,12882,4903,5316,5000708
5043,90140,3902,3902,2884,2988,1018,914,3812.0,,2770.0,,1042.0,,3800,3800,2744,2737,1056,1063,5108808
5044,90158,6229,6229,4704,4625,1525,1604,6186.0,,4924.0,,1262.0,,6280,6280,4427,4252,1853,2028,5000807
5045,90166,2688,2688,2046,2004,642,684,2630.0,,2172.0,,458.0,,2634,2634,1905,1757,729,877,5108857
5046,90174,7604,7604,5908,5903,1696,1701,7558.0,,6190.0,,1368.0,,6787,6787,5265,5055,1522,1732,5000906
5047,90182,3123,3123,2401,2359,722,764,3063.0,,2490.0,,573.0,,3212,3212,2291,2235,921,977,5106851
5048,90190,19301,19301,13842,14094,5459,5207,18835.0,,13662.0,,5173.0,,18314,18314,12804,12665,5510,5649,5001003
5049,90204,2650,2650,2043,2056,607,594,2642.0,,2271.0,,371.0,,2603,2603,1886,1895,717,708,5103957
5050,90212,35880,35880,26511,26005,9369,9875,35023.0,,25736.0,,9287.0,,33863,33863,24702,23688,9161,10175,5001102
5051,90220,7072,7072,5078,5143,1994,1929,6901.0,,5092.0,,1809.0,,6864,6864,4770,4639,2094,2225,5107941
5052,90239,1042,1042,834,797,208,245,1001.0,,933.0,,68.0,,948,948,733,682,215,266,5101209
5053,90247,4472,4472,2945,2926,1527,1546,4345.0,,3122.0,,1223.0,,4343,4343,2819,2685,1524,1658,5107354
5054,90255,8054,8054,6133,6073,1921,1981,7923.0,,5925.0,,1998.0,,7803,7803,5573,5369,2230,2434,5101308
5055,90263,5717,5717,4271,4297,1446,1420,5378.0,,4180.0,,1198.0,,5262,5262,3743,3594,1519,1668,5100805
5056,90271,13988,13988,9357,9653,4631,4335,12957.0,,8640.0,,4317.0,,12407,12407,8123,7778,4284,4629,5101407
5057,90280,22080,22080,16181,16245,5899,5835,20232.0,,14990.0,,5242.0,,18703,18703,13559,12914,5144,5789,5103353
5058,90298,6166,6166,4811,4712,1355,1454,6060.0,,4689.0,,1371.0,,5856,5856,4592,4411,1264,1445,5001508
5059,90301,4391,4391,3151,3109,1240,1282,4402.0,,3535.0,,867.0,,4664,4664,3251,3074,1413,1590,5105234
5060,90310,6112,6112,4974,4688,1138,1424,5856.0,,5174.0,,682.0,,5297,5297,4464,4002,833,1295,5101605
5061,90328,2279,2279,1744,1714,535,565,2303.0,,1958.0,,345.0,,2404,2404,1694,1555,710,849,5107263
5062,90336,24100,24100,17923,18052,6177,6048,23691.0,,17942.0,,5749.0,,23247,23247,17091,16529,6156,6718,5101704
5063,90344,2655,2655,2036,2021,619,634,2546.0,,2213.0,,333.0,,2495,2495,1994,2165,501,330,5106455
5064,90352,47757,47757,34391,35202,13366,12555,46109.0,,32241.0,,13868.0,,43161,43161,31394,30377,11767,12784,5101803
5065,90360,6101,6101,4444,4557,1657,1544,5981.0,,4285.0,,1696.0,,5714,5714,4018,3941,1696,1773,5108956
5066,90379,19335,19335,14122,14011,5213,5324,18758.0,,13908.0,,4850.0,,17767,17767,12694,12228,5073,5539,5001904
5067,90387,9327,9327,6631,6731,2696,2596,8859.0,,6258.0,,2601.0,,9003,9003,6112,6006,2891,2997,5106158
5068,90395,8175,8175,6242,6229,1933,1946,8066.0,,6223.0,,1843.0,,8544,8544,6250,6083,2294,2461,5002001
5069,90409,3624,3624,2770,2747,854,877,3546.0,,2932.0,,614.0,,3414,3414,2650,2522,764,892,5107404
5070,90417,16295,16295,11981,11919,4314,4376,16001.0,,11736.0,,4265.0,,16287,16287,11741,11316,4546,4971,5002100
5071,90425,8518,8518,6211,6328,2307,2190,8585.0,,6467.0,,2118.0,,8305,8305,5857,5762,2448,2543,5103379
5072,90433,17682,17682,13657,13580,4025,4102,17046.0,,13026.0,,4020.0,,16684,16684,12822,12424,3862,4260,5002209
5073,90441,2099,2099,1668,1654,431,445,2109.0,,1828.0,,281.0,,1936,1936,1540,1437,396,499,5107198
5074,90450,9469,9469,6454,6467,3015,3002,9324.0,,6392.0,,2932.0,,9714,9714,6608,6217,3106,3497,5002308
5075,90468,11831,11831,8364,8481,3467,3350,11495.0,,8290.0,,3205.0,,11480,11480,7963,7783,3517,3697,5101902
5076,90476,66035,66035,47738,48113,18297,17922,64839.0,,44747.0,,20092.0,,61684,61684,44844,43951,16840,17733,5102504
5077,90484,26883,26883,20002,20601,6881,6282,24809.0,,17743.0,,7066.0,,22019,22019,16137,15761,5882,6258,5102637
5078,90492,11108,11108,8599,8500,2509,2608,10914.0,,8394.0,,2520.0,,11215,11215,8424,7957,2791,3258,5002605
5079,90506,31645,31645,24154,24298,7491,7347,29781.0,,22054.0,,7727.0,,28928,28928,21907,21329,7021,7599,5102678
5080,90514,639873,639873,527474,525411,112399,114462,612487.0,,458484.0,,154003.0,,591374,591374,518800,514456,72574,76918,5002704
5081,90522,8163,8163,6302,6435,1861,1728,7927.0,,6120.0,,1807.0,,7755,7755,5580,5478,2175,2277,5103056
5082,90530,4553,4553,3524,3407,1029,1146,4555.0,,3870.0,,685.0,,4527,4527,3356,3124,1171,1403,5002803
5083,90549,5724,5724,4268,4279,1456,1445,5507.0,,3938.0,,1569.0,,5790,5790,4179,4089,1611,1701,5102850
5084,90557,20849,20849,16381,16453,4468,4396,19926.0,,15503.0,,4423.0,,20409,20409,15755,15336,4654,5073,5002407
5085,90565,6935,6935,5579,5219,1356,1716,6820.0,,5846.0,,974.0,,6377,6377,5263,4834,1114,1543,5104906
5086,90573,16093,16093,11399,11591,4694,4502,16480.0,,11772.0,,4708.0,,16471,16471,11539,11218,4932,5253,5002902
5087,90581,6319,6319,4549,4623,1770,1696,5997.0,,4510.0,,1487.0,,6062,6062,4180,4100,1882,1962,5105176
5088,90590,16732,16732,12863,12669,3869,4063,15755.0,,12188.0,,3567.0,,15364,15364,11767,11013,3597,4351,5103007
5089,90603,49625,49625,37280,38099,12345,11526,46130.0,,32637.0,,13493.0,,42603,42603,32174,31604,10429,10999,5105259
5090,90611,4037,4037,3061,2966,976,1071,4016.0,,3310.0,,706.0,,3662,3662,2804,2574,858,1088,5003108
5091,90620,13241,13241,9790,10005,3451,3236,12872.0,,9754.0,,3118.0,,11482,11482,8388,8157,3094,3325,5105606
5092,90638,70963,70963,52903,51865,18060,19098,70238.0,,51962.0,,18276.0,,69302,69302,52151,50411,17151,18891,5003207
5093,90646,32416,32416,24823,25411,7593,7005,29265.0,,21010.0,,8255.0,,26941,26941,21072,20659,5869,6282,5106224
5094,90654,26196,26196,19246,19172,6950,7024,25799.0,,18666.0,,7133.0,,25232,25232,18150,17326,7082,7906,5003306
5095,90662,7298,7298,5155,5122,2143,2176,6808.0,,5095.0,,1713.0,,6658,6658,4596,4375,2062,2283,5107180
5096,90670,427797,427797,358602,357652,69195,70145,378097.0,378097.0,294861.0,284352.0,83236.0,93745.0,440338,440338,356297,351380,84041,88958,5103403
5097,90689,9019,9019,6632,6846,2387,2173,8970.0,,6643.0,,2327.0,,7926,7926,5792,5627,2134,2299,5108006
5098,90697,16407,16407,12499,12670,3908,3737,15993.0,,12121.0,,3872.0,,15578,15578,11555,11092,4023,4486,5103502
5099,90700,4951,4951,3811,3815,1140,1136,4925.0,,3965.0,,960.0,,5002,5002,3794,3648,1208,1354,5106653
5100,90719,6340,6340,4856,4873,1484,1467,6499.0,,5133.0,,1366.0,,6454,6454,4773,4465,1681,1989,5103601
5101,90727,19096,19096,13313,13695,5783,5401,17938.0,,12479.0,,5459.0,,14773,14773,10147,9933,4626,4840,5107875
5102,90735,169042,169042,133855,134465,35187,34577,164395.0,,120009.0,,44386.0,,156373,156373,122142,122193,34231,34180,5003702
5103,90743,5295,5295,3919,3968,1376,1327,4780.0,,3663.0,,1117.0,,4291,4291,3219,3118,1072,1173,5102686
5104,90751,16563,16563,13101,13177,3462,3386,16197.0,,12507.0,,3690.0,,16269,16269,12650,12551,3619,3718,5003801
5105,90760,7848,7848,5836,5925,2012,1923,7457.0,,5497.0,,1960.0,,7401,7401,5369,5292,2032,2109,5102793
5106,90778,4123,4123,3107,3066,1016,1057,3964.0,,3358.0,,606.0,,3919,3919,2941,2713,978,1206,5103908
5107,90786,6258,6258,4594,4685,1664,1573,5982.0,,4458.0,,1524.0,,6100,6100,4237,4158,1863,1942,5103700
5108,90794,7727,7727,6103,6052,1624,1675,7606.0,,6171.0,,1435.0,,7652,7652,5898,5755,1754,1897,5004007
5109,90808,5276,5276,3883,3915,1393,1361,5016.0,,3774.0,,1242.0,,5064,5064,3550,3497,1514,1567,5106265
5110,90816,7743,7743,5751,5671,1992,2072,7502.0,,5791.0,,1711.0,,7521,7521,5506,5293,2015,2228,5004106
5111,90824,5411,5411,3995,4080,1416,1331,4974.0,,3719.0,,1255.0,,4928,4928,3454,3365,1474,1563,5103858
5112,90832,8399,8399,6444,6448,1955,1951,8310.0,,6577.0,,1733.0,,8416,8416,6138,5934,2278,2482,5104203
5113,90840,3024,3024,2261,2282,763,742,2667.0,,2053.0,,614.0,,2541,2541,1787,1758,754,783,5108303
5114,90859,10633,10633,7832,7762,2801,2871,10224.0,,7849.0,,2375.0,,10536,10536,7335,7128,3201,3408,5004304
5115,90867,4615,4615,3121,3112,1494,1503,4492.0,,3265.0,,1227.0,,4478,4478,3039,2859,1439,1619,5106182
5116,90875,6524,6524,4623,4557,1901,1967,6321.0,,4830.0,,1491.0,,6505,6505,4435,4092,2070,2413,5004403
5117,90883,7681,7681,5637,5674,2044,2007,6766.0,,5065.0,,1701.0,,6370,6370,4447,4255,1923,2115,5106240
5118,90891,13983,13983,11315,11443,2668,2540,13987.0,,11429.0,,2558.0,,13321,13321,10566,10426,2755,2895,5004502
5119,90905,5006,5006,3474,3418,1532,1588,4641.0,,3485.0,,1156.0,,4633,4633,3150,2958,1483,1675,5101852
5120,90913,9145,9145,6690,6659,2455,2486,9191.0,,7170.0,,2021.0,,8657,8657,6209,5969,2448,2688,5104609
5121,90921,1617,1617,1149,1119,468,498,1578.0,,1314.0,,264.0,,1379,1379,916,890,463,489,5107883
5122,90930,20510,20510,15931,16104,4579,4406,19719.0,,15494.0,,4225.0,,19044,19044,14891,14679,4153,4365,5004700
5123,90948,1850,1850,1285,1250,565,600,1775.0,,1432.0,,343.0,,1701,1701,1158,1046,543,655,5106315
5124,90956,20129,20129,15681,15863,4448,4266,19443.0,,14804.0,,4639.0,,19246,19246,15453,15202,3793,4044,5104807
5125,90964,2754,2754,1794,1884,960,870,2649.0,,2136.0,,513.0,,2392,2392,1462,1540,930,852,5106174
5126,90972,5237,5237,4089,3961,1148,1276,5262.0,,4098.0,,1164.0,,4804,4804,3700,3567,1104,1237,5004908
5127,90980,1876,1876,1324,1320,552,556,1673.0,,1382.0,,291.0,,1571,1571,1060,1003,511,568,5107743
5128,90999,18374,18374,13386,13416,4988,4958,17850.0,,12911.0,,4939.0,,18227,18227,13174,12659,5053,5568,5005004
5129,91006,3022,3022,2161,2190,861,832,2848.0,,2270.0,,578.0,,2851,2851,2030,1932,821,919,5103361
5130,91014,4151,4151,3380,3324,771,827,3996.0,,3445.0,,551.0,,3827,3827,3008,2720,819,1107,5005103
5131,91022,2655,2655,1942,1949,713,706,2650.0,,2105.0,,545.0,,2592,2592,1971,1916,621,676,5108352
5132,91030,14088,14088,10430,10185,3658,3903,14212.0,,10599.0,,3613.0,,13404,13404,9791,9484,3613,3920,5005202
5133,91049,2337,2337,1657,1653,680,684,2314.0,,1846.0,,468.0,,2036,2036,1386,1278,650,758,5107768
5134,91057,2189,2189,1673,1636,516,553,2095.0,,1854.0,,241.0,,1946,1946,1459,1379,487,567,5105309
5135,91073,28259,28259,22287,22431,5972,5828,27330.0,,21830.0,,5500.0,,27441,27441,21395,21095,6046,6346,5005400
5136,91081,4841,4841,3702,3809,1139,1032,4743.0,,3843.0,,900.0,,3997,3997,3002,2963,995,1034,5104526
5137,91090,10521,10521,7703,7450,2818,3071,9933.0,,7612.0,,2321.0,,9996,9996,7296,6730,2700,3266,5105507
5138,91103,5146,5146,3847,3979,1299,1167,4998.0,,3678.0,,1320.0,,4421,4421,3132,3028,1289,1393,5104542
5139,91111,19453,19453,14681,14104,4772,5349,19013.0,,14051.0,,4962.0,,19171,19171,14394,13597,4777,5574,5005608
5140,91138,36937,36937,27964,28084,8973,8853,36167.0,,26309.0,,9858.0,,36133,36133,26609,26109,9524,10024,5005707
5141,91154,10677,10677,8101,7926,2576,2751,10658.0,,8458.0,,2200.0,,10469,10469,7785,7378,2684,3091,5005806
5142,91170,11659,11659,9176,9153,2483,2506,11211.0,,9035.0,,2176.0,,11003,11003,8657,8305,2346,2698,5105903
5143,91197,4786,4786,3774,3698,1012,1088,4729.0,,3835.0,,894.0,,4583,4583,3632,3475,951,1108,5106000
5144,91219,12117,12117,9863,9519,2254,2598,11532.0,,9703.0,,1829.0,,11241,11241,9051,8334,2190,2907,5106109
5145,91235,34908,34908,26062,26138,8846,8770,33366.0,,24419.0,,8947.0,,33942,33942,24718,24123,9224,9819,5006200
5146,91251,31288,31288,23583,23768,7705,7520,30412.0,,22933.0,,7479.0,,30760,30760,22495,22358,8265,8402,5006309
5147,91278,5828,5828,4389,4413,1439,1415,5840.0,,4615.0,,1225.0,,5988,5988,4329,4117,1659,1871,5006408
5148,91294,24030,24030,18333,18298,5697,5732,22944.0,,17452.0,,5492.0,,22902,22902,17572,16983,5330,5919,5106505
5149,91316,70278,70278,53150,52976,17128,17302,66918.0,,47535.0,,19383.0,,63352,63352,47921,46887,15431,16465,5006606
5150,91332,1921,1921,1461,1420,460,501,1902.0,,1598.0,,304.0,,1776,1776,1383,1270,393,506,5106703
5151,91359,4011,4011,3023,3108,988,903,3868.0,,3002.0,,866.0,,4077,4077,2836,2778,1241,1299,5106802
5152,91375,8386,8386,5663,5442,2723,2944,8164.0,,5786.0,,2378.0,,8322,8322,5547,4996,2775,3326,5006903
5153,91391,14457,14457,9998,10053,4459,4404,14274.0,,10329.0,,3945.0,,13227,13227,9010,8572,4217,4655,5107008
5154,91413,14569,14569,10301,10226,4268,4343,14070.0,,10463.0,,3607.0,,14335,14335,9938,9630,4397,4705,5007109
5155,91430,25161,25161,19545,19504,5616,5657,24750.0,,18807.0,,5943.0,,25126,25126,19241,19041,5885,6085,5007208
5156,91456,3935,3935,3050,3037,885,898,3784.0,,2990.0,,794.0,,3925,3925,2948,2783,977,1142,5007307
5157,91472,14579,14579,10777,10661,3802,3918,14488.0,,11030.0,,3458.0,,14170,14170,10257,9835,3913,4335,5007406
5158,91499,4422,4422,3420,3319,1002,1103,4168.0,,3376.0,,792.0,,4039,4039,3187,2978,852,1061,5007505
5159,91510,166170,166170,128749,130427,37421,35743,155538.0,,109985.0,,45553.0,,150813,150813,115419,114415,35394,36398,5107602
5160,91537,12883,12883,9816,9494,3067,3389,12773.0,,9891.0,,2882.0,,12546,12546,9530,8754,3016,3792,5107701
5161,91553,16292,16292,13168,12745,3124,3547,15566.0,,12631.0,,2935.0,,15258,15258,12695,11863,2563,3395,5107800
5162,91570,33114,33114,25718,25373,7396,7741,31288.0,,24111.0,,7177.0,,30804,30804,23651,22969,7153,7835,5007901
5163,91596,13258,13258,10459,10223,2799,3035,13008.0,,10493.0,,2515.0,,12638,12638,10153,9716,2485,2922,5008008
5164,91618,2830,2830,2157,2012,673,818,2826.0,,2474.0,,352.0,,2540,2540,1660,1485,880,1055,5108105
5165,91634,3427,3427,2700,2671,727,756,3308.0,,2832.0,,476.0,,3087,3087,2492,2348,595,739,5108204
5166,91650,88165,88165,65930,66491,22235,21674,83973.0,,57810.0,,26163.0,,77800,77800,56625,56644,21175,21156,5008305
5167,91677,178509,178509,147139,147211,31370,31298,160409.0,,126017.0,,34392.0,,189781,189781,150006,148123,39775,41658,5108402
5168,91693,8666,8666,6479,6550,2187,2116,8377.0,,6529.0,,1848.0,,8276,8276,6284,6156,1992,2120,5000856
5169,91715,7495,7495,6143,6104,1352,1391,7348.0,,6382.0,,966.0,,6675,6675,5392,5067,1283,1608,5001243
5170,91731,8942,8942,6465,6453,2477,2489,8801.0,,6497.0,,2304.0,,8894,8894,6289,6141,2605,2753,5003751
5171,91758,10411,10411,8123,8077,2288,2334,10086.0,,7780.0,,2306.0,,10216,10216,7754,7565,2462,2651,5003454
5172,91774,19870,19870,14749,15075,5121,4795,19613.0,,14382.0,,5231.0,,19548,19548,13910,13628,5638,5920,5105622
5173,91782,21128,21128,15623,15975,5505,5153,20137.0,,13429.0,,6708.0,,17319,17319,12879,12642,4440,4677,5002951
5174,91790,14245,14245,10773,10864,3472,3381,13725.0,,10587.0,,3138.0,,13917,13917,10441,10320,3476,3597,5005681
5175,91804,8221,8221,6352,6269,1869,1952,8068.0,,6572.0,,1496.0,,7982,7982,6079,5801,1903,2181,5003488
5176,91812,14219,14219,10694,10932,3525,3287,13980.0,,10690.0,,3290.0,,12733,12733,9393,9117,3340,3616,5106372
5177,91820,5516,5516,4174,4146,1342,1370,5349.0,,4406.0,,943.0,,5180,5180,3920,3760,1260,1420,5005152
5178,91839,7681,7681,5207,5198,2474,2483,7539.0,,5554.0,,1985.0,,7063,7063,4572,4256,2491,2807,5107859
5179,91847,8598,8598,6328,6152,2270,2446,8401.0,,6721.0,,1680.0,,7963,7963,5809,5674,2154,2289,5006358
5180,91855,72256,72256,52760,54419,19496,17837,69332.0,,46607.0,,22725.0,,65681,65681,47794,47232,17887,18449,5107958
5181,91863,5116,5116,3786,3694,1330,1422,4849.0,,3826.0,,1023.0,,4658,4658,3326,3151,1332,1507,5007554
5182,91880,11147,11147,8449,8499,2698,2648,10822.0,,8485.0,,2337.0,,11071,11071,8140,7864,2931,3207,5007935
5183,91898,9272,9272,6929,6986,2343,2286,9304.0,,7254.0,,2050.0,,8903,8903,6674,6436,2229,2467,5105200
5184,91901,5705,5705,4695,4676,1010,1029,5499.0,,4683.0,,816.0,,5435,5435,4456,4380,979,1055,5008404
5185,91910,19622,19622,14350,14696,5272,4926,18375.0,,13545.0,,4830.0,,16908,16908,11586,11414,5322,5494,5100201
5186,91936,16403,16403,11801,12220,4602,4183,15553.0,,10957.0,,4596.0,,14744,14744,10314,10071,4430,4673,5102702
5187,91952,16337,16337,11370,11890,4967,4447,15853.0,,11564.0,,4289.0,,15078,15078,10414,10097,4664,4981,5106257
5188,91979,4959,4959,3515,3408,1444,1551,4851.0,,3667.0,,1184.0,,4894,4894,3272,3077,1622,1817,5107776
5189,91995,11573,11573,8518,8677,3055,2896,11525.0,,8600.0,,2925.0,,11239,11239,7970,7737,3269,3502,5107305
5190,92002,3383,3383,2785,2691,598,692,3300.0,,2897.0,,403.0,,3152,3152,2617,2363,535,789,1703206
5191,92010,10831,10831,8686,8784,2145,2047,10287.0,,8509.0,,1778.0,,9079,9079,7573,7478,1506,1601,5200100
5192,92029,6725,6725,5528,5540,1197,1185,6237.0,,5486.0,,751.0,,5192,5192,4613,4525,579,667,5203559
5193,92037,2298,2298,1833,1781,465,517,2263.0,,2034.0,,229.0,,2208,2208,1748,1566,460,642,5200209
5194,92045,6342,6342,5203,5133,1139,1209,5925.0,,5144.0,,781.0,,5923,5923,4980,4818,943,1105,1703800
5195,92053,20212,20212,16150,16337,4062,3875,19298.0,,15785.0,,3513.0,,17735,17735,14864,14737,2871,2998,5200308
5196,92061,4043,4043,3121,2986,922,1057,4062.0,,3490.0,,572.0,,3506,3506,2835,2716,671,790,5204953
5197,92070,5100,5100,4081,3946,1019,1154,4744.0,,4108.0,,636.0,,4782,4782,3817,3478,965,1304,1700400
5198,92088,3766,3766,3052,2964,714,802,3591.0,,3092.0,,499.0,,3463,3463,2919,2742,544,721,1703909
5199,92096,2068,2068,1688,1672,380,396,1979.0,,1795.0,,184.0,,1790,1790,1501,1444,289,346,5200506
5200,92100,7027,7027,5635,5664,1392,1363,7080.0,,5749.0,,1331.0,,7138,7138,5772,5497,1366,1641,5205455
5201,92118,6997,6997,5346,5317,1651,1680,6175.0,,4910.0,,1265.0,,5551,5551,4230,4084,1321,1467,5200605
5202,92126,3452,3452,2553,2392,899,1060,3343.0,,2864.0,,479.0,,3102,3102,2312,2079,790,1023,5205521
5203,92134,7282,7282,5721,5558,1561,1724,6948.0,,5667.0,,1281.0,,6757,6757,5052,4797,1705,1960,1700707
5204,92142,3675,3675,3012,2955,663,720,3633.0,,3249.0,,384.0,,3509,3509,2833,2676,676,833,1705557
5205,92150,6703,6703,5123,4938,1580,1765,6538.0,,5438.0,,1100.0,,6238,6238,4771,4418,1467,1820,5200803
5206,92169,2855,2855,2373,2330,482,525,2614.0,,2416.0,,198.0,,2325,2325,2020,1950,305,375,5213855
5207,92177,3591,3591,2892,2983,699,608,3509.0,,3094.0,,415.0,,3359,3359,2851,2747,508,612,5200902
5208,92185,5351,5351,4354,4271,997,1080,5189.0,,4376.0,,813.0,,5312,5312,4188,3899,1124,1413,1707108
5209,92193,7163,7163,5788,5545,1375,1618,7007.0,,5975.0,,1032.0,,6880,6880,5824,5417,1056,1463,1701002
5210,92207,3988,3988,3021,3138,967,850,3898.0,,3281.0,,617.0,,3843,3843,2987,2916,856,927,5207352
5211,92215,286671,286671,221533,224904,65138,61767,269556.0,269556.0,194919.0,180832.0,74637.0,88724.0,268394,268394,210815,208844,57579,59550,5201108
5212,92223,6180,6180,4766,4740,1414,1440,6233.0,,5195.0,,1038.0,,6051,6051,4773,4422,1278,1629,5207535
5213,92231,1234,1234,907,898,327,336,1153.0,,1071.0,,82.0,,1050,1050,871,817,179,233,5201207
5214,92240,4363,4363,3661,3436,702,927,4234.0,,3824.0,,410.0,,3840,3840,3255,2983,585,857,1708304
5215,92258,15005,15005,12193,12329,2812,2676,14369.0,,12011.0,,2358.0,,13574,13574,11624,11175,1950,2399,5201306
5216,92266,3680,3680,2990,2992,690,688,3612.0,,3186.0,,426.0,,3488,3488,2939,2900,549,588,5209150
5217,92274,334859,334859,262941,266092,71918,68767,308749.0,,229049.0,,79700.0,,297995,297995,234559,233375,63436,64620,5201405
5218,92282,4808,4808,4001,3969,807,839,4798.0,,4216.0,,582.0,,4504,4504,3677,3563,827,941,5210562
5219,92290,3190,3190,2325,2317,865,873,3198.0,,2699.0,,499.0,,3036,3036,2311,2192,725,844,5201504
5220,92304,3445,3445,2733,2697,712,748,3185.0,,2756.0,,429.0,,3056,3056,2438,2239,618,817,1712504
5221,92312,4008,4008,3337,3308,671,700,3924.0,,3344.0,,580.0,,3739,3739,3222,3088,517,651,5201603
5222,92320,3712,3712,2959,2927,753,785,3496.0,,3106.0,,390.0,,3256,3256,2717,2572,539,684,5212956
5223,92339,13527,13527,10343,10575,3184,2952,13088.0,,10514.0,,2574.0,,11186,11186,9306,9057,1880,2129,5201702
5224,92347,3023,3023,2525,2395,498,628,2971.0,,2719.0,,252.0,,2466,2466,2111,1938,355,528,5213053
5225,92355,8754,8754,6904,6954,1850,1800,8299.0,,6900.0,,1399.0,,7715,7715,6094,5904,1621,1811,5201801
5226,92363,9468,9468,7373,7682,2095,1786,9170.0,,7472.0,,1698.0,,8874,8874,6939,6858,1935,2016,5213756
5227,92371,4789,4789,3709,3605,1080,1184,4635.0,,3904.0,,731.0,,4595,4595,3609,3321,986,1274,1701903
5228,92398,6322,6322,5004,4998,1318,1324,6242.0,,5255.0,,987.0,,6388,6388,4976,4708,1412,1680,1702000
5229,92401,2720,2720,2212,2174,508,546,2645.0,,2225.0,,420.0,,2726,2726,2178,1967,548,759,1715002
5230,92410,112913,112913,93201,92665,19712,20248,105288.0,,83943.0,,21345.0,,110079,110079,87224,84397,22855,25682,1702109
5231,92436,21374,21374,16863,16531,4511,4843,20548.0,,16513.0,,4035.0,,20838,20838,16567,15707,4271,5131,1702208
5232,92444,3705,3705,2841,2791,864,914,3607.0,,3125.0,,482.0,,3223,3223,2528,2494,695,729,5215256
5233,92452,4712,4712,3716,3595,996,1117,4579.0,,3905.0,,674.0,,4566,4566,3686,3404,880,1162,1702307
5234,92460,3573,3573,2781,2794,792,779,3544.0,,3111.0,,433.0,,3244,3244,2482,2243,762,1001,5215652
5235,92479,7864,7864,5994,5918,1870,1946,7503.0,,5926.0,,1577.0,,7749,7749,5641,5282,2108,2467,1702406
5236,92487,4113,4113,3476,3349,637,764,3956.0,,3573.0,,383.0,,3713,3713,3103,2875,610,838,1716653
5237,92495,7096,7096,4825,4758,2271,2338,6414.0,,4938.0,,1476.0,,5938,5938,4279,3957,1659,1981,5202502
5238,92509,2271,2271,1770,1713,501,558,2121.0,,1768.0,,353.0,,2189,2189,1662,1528,527,661,1718006
5239,92517,3207,3207,2452,2506,755,701,3154.0,,2742.0,,412.0,,3205,3205,2494,2418,711,787,5202601
5240,92525,5514,5514,4319,4205,1195,1309,5368.0,,4573.0,,795.0,,5086,5086,4090,3951,996,1135,1718303
5241,92533,3049,3049,2456,2314,593,735,3059.0,,2725.0,,334.0,,2975,2975,2345,2095,630,880,1702703
5242,92541,3676,3676,2827,2715,849,961,3261.0,,2867.0,,394.0,,3025,3025,2371,2246,654,779,1718808
5243,92550,3333,3333,2745,2695,588,638,3159.0,,2859.0,,300.0,,2750,2750,2446,2302,304,448,5202809
5244,92568,4056,4056,3064,3061,992,995,3921.0,,3359.0,,562.0,,3509,3509,2740,2580,769,929,5219258
5245,92576,8768,8768,7135,6999,1633,1769,8343.0,,7235.0,,1108.0,,8111,8111,6844,6619,1267,1492,1702901
5246,92584,4011,4011,3354,3139,657,872,3854.0,,3447.0,,407.0,,3683,3683,2970,2699,713,984,1718907
5247,92592,6311,6311,5320,5172,991,1139,6133.0,,5483.0,,650.0,,5952,5952,5126,4875,826,1077,1703008
5248,92606,2861,2861,2464,2350,397,511,2853.0,,2650.0,,203.0,,2428,2428,2058,1815,370,613,1719004
5249,92614,2871,2871,2175,2077,696,794,2763.0,,2437.0,,326.0,,2334,2334,1887,1785,447,549,5203104
5250,92622,2225,2225,1690,1707,535,518,2188.0,,1995.0,,193.0,,1825,1825,1529,1433,296,392,5220058
5251,92630,9616,9616,7319,7345,2297,2271,9363.0,,7880.0,,1483.0,,8775,8775,6767,6399,2008,2376,5203203
5252,92649,4775,4775,3659,3597,1116,1178,4886.0,,4341.0,,545.0,,3907,3907,3207,2997,700,910,5220157
5253,92657,23292,23292,17518,17980,5774,5312,22041.0,,17070.0,,4971.0,,21555,21555,16521,16181,5034,5374,5203302
5254,92665,3463,3463,2904,2905,559,558,3362.0,,3012.0,,350.0,,3174,3174,2777,2688,397,486,5220264
5255,92673,6961,6961,5390,5474,1571,1487,6702.0,,5827.0,,875.0,,6025,6025,5062,4874,963,1151,5203401
5256,92681,3726,3726,2933,2830,793,896,3560.0,,3082.0,,478.0,,3354,3354,2697,2434,657,920,1720499
5257,92690,17578,17578,13076,13194,4502,4384,16831.0,,12886.0,,3945.0,,16006,16006,12405,12199,3601,3807,5203500
5258,92703,83963,83963,66666,66809,17297,17154,76992.0,,62814.0,,14178.0,,71061,71061,56091,55122,14970,15939,5220454
5259,92711,3537,3537,2718,2741,819,796,3321.0,,2789.0,,532.0,,3082,3082,2428,2308,654,774,5203609
5260,92720,5727,5727,4251,4203,1476,1524,5791.0,,4883.0,,908.0,,5378,5378,4078,3870,1300,1508,5220686
5261,92738,3862,3862,3227,3114,635,748,3752.0,,3292.0,,460.0,,3829,3829,3196,2929,633,900,1703701
5262,92754,4762,4762,3708,3666,1054,1096,4646.0,,3914.0,,732.0,,4218,4218,3423,3213,795,1005,5203807
5263,92762,2731,2731,1981,1940,750,791,2720.0,,2451.0,,269.0,,2295,2295,1769,1637,526,658,5221080
5264,92770,8417,8417,6196,6206,2221,2211,8149.0,,6371.0,,1778.0,,7940,7940,5956,5793,1984,2147,5203906
5265,92789,3003,3003,2235,2193,768,810,2991.0,,2608.0,,383.0,,2742,2742,2106,2011,636,731,5221452
5266,92797,6822,6822,5364,5355,1458,1467,6654.0,,5852.0,,802.0,,5736,5736,4697,4464,1039,1272,5204003
5267,92800,4081,4081,3171,3194,910,887,4030.0,,3539.0,,491.0,,3680,3680,3122,3343,558,337,5221551
5268,92819,8260,8260,6085,6153,2175,2107,8140.0,,6553.0,,1587.0,,7605,7605,5929,5708,1676,1897,5204102
5269,92827,3939,3939,3023,2948,916,991,3928.0,,3403.0,,525.0,,3400,3400,2712,2571,688,829,5218789
5270,92835,1884,1884,1429,1382,455,502,1927.0,,1738.0,,189.0,,1732,1732,1368,1231,364,501,5204201
5271,92851,10886,10886,8199,8445,2687,2441,10640.0,,8456.0,,2184.0,,9789,9789,7771,7655,2018,2134,5204300
5272,92860,2334,2334,1875,1788,459,546,2328.0,,2195.0,,133.0,,2056,2056,1689,1567,367,489,5209457
5273,92878,13208,13208,9858,10161,3350,3047,13052.0,,10314.0,,2738.0,,12840,12840,9713,9425,3127,3415,5204409
5274,92886,15914,15914,12267,12360,3647,3554,15362.0,,12202.0,,3160.0,,14897,14897,11475,11107,3422,3790,5205513
5275,92894,65613,65613,49393,49847,16220,15766,61263.0,,45507.0,,15756.0,,58714,58714,45594,44938,13120,13776,5204508
5276,92908,6203,6203,4928,4941,1275,1262,5913.0,,4853.0,,1060.0,,5559,5559,4312,4132,1247,1427,5219738
5277,92916,3731,3731,2873,2856,858,875,3719.0,,3203.0,,516.0,,3604,3604,2719,2626,885,978,5204607
5278,92924,8139,8139,6360,6536,1779,1603,7620.0,,6238.0,,1382.0,,7290,7290,5700,5618,1590,1672,5205471
5279,92932,9153,9153,6916,6920,2237,2233,8591.0,,7024.0,,1567.0,,8703,8703,6954,6711,1749,1992,5204706
5280,92940,6191,6191,4583,4468,1608,1723,6221.0,,5241.0,,980.0,,5653,5653,4354,3981,1299,1672,5200555
5281,92959,5282,5282,4166,4237,1116,1045,5118.0,,4337.0,,781.0,,4915,4915,3879,3812,1036,1103,5204805
5282,92967,3665,3665,2669,2794,996,871,3853.0,,3368.0,,485.0,,3384,3384,2609,2434,775,950,5205059
5283,92975,14197,14197,10879,10893,3318,3304,13613.0,,10953.0,,2660.0,,13511,13511,10198,9763,3313,3748,5204904
5284,92983,2485,2485,1926,1930,559,555,2449.0,,2217.0,,232.0,,2196,2196,1795,1758,401,438,5212055
5285,92991,7075,7075,5592,5703,1483,1372,7028.0,,5969.0,,1059.0,,6769,6769,5558,5521,1211,1248,5205000
5286,93009,2914,2914,2226,2253,688,661,2750.0,,2260.0,,490.0,,2417,2417,1956,1871,461,546,5201454
5287,93017,74399,74399,57901,59566,16498,14833,71060.0,,54578.0,,16482.0,,69441,69441,54505,54557,14936,14884,5205109
5288,93025,43652,43652,35413,35806,8239,7846,39096.0,,30826.0,,8270.0,,36973,36973,30303,30169,6670,6804,5205497
5289,93033,4783,4783,3793,3802,990,981,4546.0,,3786.0,,760.0,,4177,4177,3336,3288,841,889,5205208
5290,93041,3039,3039,2392,2411,647,628,2964.0,,2566.0,,398.0,,2676,2676,2189,2112,487,564,5218391
5291,93050,7243,7243,5415,5294,1828,1949,6763.0,,5768.0,,995.0,,6154,6154,4559,4367,1595,1787,5205307
5292,93068,3076,3076,2340,2363,736,713,3005.0,,2449.0,,556.0,,2960,2960,2127,2060,833,900,5216452
5293,93076,16360,16360,13576,13807,2784,2553,15865.0,,13108.0,,2757.0,,15314,15314,13350,13004,1964,2310,5205406
5294,93084,2803,2803,2082,2060,721,743,2885.0,,2545.0,,340.0,,2822,2822,2168,2004,654,818,5214879
5295,93092,4832,4832,3612,3578,1220,1254,4740.0,,4141.0,,599.0,,4471,4471,3437,3833,1034,638,5208301
5296,93106,3317,3317,2640,2589,677,728,3288.0,,2994.0,,294.0,,2702,2702,2328,2111,374,591,5203939
5297,93114,23111,23111,18501,18349,4610,4762,22173.0,,17723.0,,4450.0,,23067,23067,18017,17244,5050,5823,1705508
5298,93122,3298,3298,2561,2611,737,687,3215.0,,2692.0,,523.0,,3029,3029,2298,2242,731,787,5204557
5299,93130,3325,3325,2503,2368,822,957,3221.0,,2844.0,,377.0,,3185,3185,2307,1943,878,1242,1705607
5300,93149,2635,2635,2193,2210,442,425,2560.0,,2388.0,,172.0,,2424,2424,2012,1938,412,486,5209291
5301,93157,2960,2960,2355,2469,605,491,2796.0,,2558.0,,238.0,,2361,2361,2054,1890,307,471,5205703
5302,93165,4634,4634,3663,3721,971,913,4495.0,,3903.0,,592.0,,4042,4042,3379,3362,663,680,5209937
5303,93173,7527,7527,5780,5788,1747,1739,7446.0,,5931.0,,1515.0,,7365,7365,5639,5385,1726,1980,5205802
5304,93181,3524,3524,2729,2618,795,906,3517.0,,3091.0,,426.0,,3172,3172,2509,2388,663,784,5213772
5305,93190,6835,6835,5289,5422,1546,1413,6654.0,,5783.0,,871.0,,6334,6334,4883,4763,1451,1571,5205901
5306,93203,4005,4005,3159,3235,846,770,3956.0,,3512.0,,444.0,,3726,3726,2998,2941,728,785,5219712
5307,93211,4294,4294,3434,3366,860,928,4189.0,,3627.0,,562.0,,3813,3813,3201,3052,612,761,1706001
5308,93220,6251,6251,5130,5109,1121,1142,6190.0,,5378.0,,812.0,,5871,5871,4713,4659,1158,1212,5221197
5309,93238,5385,5385,4367,4213,1018,1172,5286.0,,4468.0,,818.0,,5327,5327,4181,3806,1146,1521,1706100
5310,93246,2671,2671,2081,2017,590,654,2638.0,,2371.0,,267.0,,2264,2264,1863,1746,401,518,5221577
5311,93254,35530,35530,26865,27484,8665,8046,33179.0,,24286.0,,8893.0,,31474,31474,24895,24764,6579,6710,5206206
5312,93262,3434,3434,2475,2436,959,998,3514.0,,2999.0,,515.0,,3222,3222,2354,2224,868,998,5203962
5313,93270,3899,3899,2953,3024,946,875,3850.0,,3366.0,,484.0,,3148,3148,2559,2399,589,749,5206305
5314,93289,3801,3801,2787,2747,1014,1054,3783.0,,3088.0,,695.0,,3559,3559,2627,2493,932,1066,5222203
5315,93297,12552,12552,9421,9363,3131,3189,12152.0,,9854.0,,2298.0,,11874,11874,9503,9207,2371,2667,5206404
5316,93300,89403,89403,72838,73774,16565,15629,81923.0,,62769.0,,19154.0,,77029,77029,63378,63076,13651,13953,5221858
5317,93319,3667,3667,3053,3071,614,596,3563.0,,3173.0,,390.0,,3166,3166,2729,2611,437,555,5206503
5318,93327,49426,49426,40443,40954,8983,8472,46202.0,,37063.0,,9139.0,,40451,40451,34539,34449,5912,6002,5215231
5319,93335,2575,2575,1976,2056,599,519,2564.0,,2234.0,,330.0,,2413,2413,1945,1929,468,484,5206602
5320,93343,107255,107255,86486,87731,20769,19524,94752.0,,74949.0,,19803.0,,85376,85376,71312,70759,14064,14617,5200258
5321,93351,3799,3799,2837,2796,962,1003,3884.0,,3462.0,,422.0,,3452,3452,2609,2510,843,942,5206701
5322,93360,12229,12229,9268,9408,2961,2821,10121.0,,8260.0,,1861.0,,8375,8375,6661,6507,1714,1868,5200050
5323,93378,3458,3458,2803,2805,655,653,3492.0,,3087.0,,405.0,,3259,3259,2643,2539,616,720,5206800
5324,93386,3093,3093,2416,2377,677,716,3065.0,,2698.0,,367.0,,2916,2916,2298,2125,618,791,5200829
5325,93394,3593,3593,2689,2660,904,933,3507.0,,2980.0,,527.0,,3131,3131,2348,2764,783,367,5206909
5326,93408,3302,3302,2516,2412,786,890,3383.0,,2950.0,,433.0,,2741,2741,2222,2089,519,652,5203575
5327,93416,12753,12753,10195,9965,2558,2788,11984.0,,9658.0,,2326.0,,12630,12630,9759,9071,2871,3559,1707009
5328,93424,3620,3620,2670,2679,950,941,3559.0,,3127.0,,432.0,,2763,2763,2243,2138,520,625,5218052
5329,93432,2290,2290,1853,1870,437,420,2198.0,,2003.0,,195.0,,2093,2093,1738,1669,355,424,5207105
5330,93440,2768,2768,2215,2242,553,526,2802.0,,2549.0,,253.0,,2594,2594,2123,2043,471,551,5219456
5331,93459,4910,4910,3897,3796,1013,1114,4867.0,,4098.0,,769.0,,4730,4730,3816,3428,914,1302,1707207
5332,93475,3335,3335,2713,2644,622,691,3326.0,,2959.0,,367.0,,3149,3149,2586,2315,563,834,1707306
5333,93483,2347,2347,1892,1916,455,431,2268.0,,2068.0,,200.0,,2185,2185,1807,1688,378,497,5220280
5334,93491,9629,9629,7478,7553,2151,2076,9347.0,,7398.0,,1949.0,,9216,9216,7435,7116,1781,2100,5207402
5335,93505,5192,5192,3989,3953,1203,1239,5162.0,,4496.0,,666.0,,4678,4678,3618,3424,1060,1254,5222302
5336,93513,2956,2956,2368,2350,588,606,2941.0,,2576.0,,365.0,,2758,2758,2265,2163,493,595,5207501
5337,93530,5215,5215,4312,4273,903,942,4996.0,,4480.0,,516.0,,4754,4754,3982,3733,772,1021,5207600
5338,93548,3045,3045,2491,2436,554,609,2987.0,,2746.0,,241.0,,2606,2606,2190,2109,416,497,5210158
5339,93556,6187,6187,5023,4786,1164,1401,5900.0,,5060.0,,840.0,,5849,5849,4782,4354,1067,1495,1707702
5340,93564,3165,3165,2631,2657,534,508,3042.0,,2747.0,,295.0,,2760,2760,2401,2323,359,437,5208152
5341,93572,8333,8333,6628,6715,1705,1618,7968.0,,6699.0,,1269.0,,7852,7852,6436,6240,1416,1612,5207808
5342,93580,6124,6124,4833,4836,1291,1288,5796.0,,4944.0,,852.0,,5543,5543,4417,4311,1126,1232,5204854
5343,93599,6998,6998,5122,5070,1876,1928,6779.0,,5603.0,,1176.0,,6290,6290,4617,4470,1673,1820,5207907
5344,93602,1601,1601,1147,1143,454,458,1605.0,,1384.0,,221.0,,1474,1474,1082,987,392,487,5212253
5345,93610,75027,75027,59376,60367,15651,14660,70606.0,,53717.0,,16889.0,,68292,68292,56212,55943,12080,12349,5208004
5346,93637,4566,4566,3507,3498,1059,1068,4418.0,,3942.0,,476.0,,4091,4091,3203,2985,888,1106,5208103
5347,93653,13706,13706,10907,10686,2799,3020,12999.0,,10763.0,,2236.0,,13421,13421,10444,9759,2977,3662,1708205
5348,93670,10434,10434,8209,8209,2225,2225,10299.0,,8506.0,,1793.0,,10241,10241,8085,7927,2156,2314,5208400
5349,93696,4259,4259,3526,3593,733,666,4124.0,,3570.0,,554.0,,3883,3883,3324,3317,559,566,5208509
5350,93718,57111,57111,43763,44919,13348,12192,52818.0,,41467.0,,11351.0,,50529,50529,40236,39704,10293,10825,5208608
5351,93734,1032004,1032004,819855,830101,212149,201903,971221.0,971221.0,672859.0,614272.0,298362.0,356949.0,977479,977479,776114,765971,201365,211508,5208707
5352,93750,41108,41108,30965,31211,10143,9897,36412.0,,26217.0,,10195.0,,33462,33462,24625,24209,8837,9253,5208806
5353,93777,19618,19618,14823,14974,4795,4644,18960.0,,14596.0,,4364.0,,18649,18649,14708,14107,3941,4542,5208905
5354,93793,26772,26772,21226,21793,5546,4979,25613.0,,21148.0,,4465.0,,24650,24650,20286,19914,4364,4736,5209101
5355,93815,13799,13799,10490,10557,3309,3242,13054.0,,10239.0,,2815.0,,12582,12582,9661,9452,2921,3130,5209200
5356,93831,4161,4161,3423,3365,738,796,3923.0,,3571.0,,352.0,,3461,3461,2957,2792,504,669,5209408
5357,93858,58211,58211,46745,46601,11466,11610,54303.0,,42252.0,,12051.0,,57214,57214,44217,42407,12997,14807,1709500
5358,93874,3972,3972,3131,3103,841,869,3979.0,,3569.0,,410.0,,3291,3291,2772,2638,519,653,5209606
5359,93890,18752,18752,14670,14715,4082,4037,17799.0,,14190.0,,3609.0,,16157,16157,12646,12315,3511,3842,5209705
5360,93912,3602,3602,3028,2983,574,619,3523.0,,3307.0,,216.0,,3288,3288,2805,2576,483,712,5209804
5361,93939,7806,7806,6096,6005,1710,1801,7458.0,,6283.0,,1175.0,,6960,6960,5716,5482,1244,1478,5209903
5362,93955,41069,41069,31966,32414,9103,8655,39680.0,,29410.0,,10270.0,,39834,39834,31038,30602,8796,9232,5210000
5363,93971,20230,20230,15506,15888,4724,4342,19579.0,,15374.0,,4205.0,,19450,19450,15206,14898,4244,4552,5210109
5364,93998,25860,25860,19853,20309,6007,5551,24721.0,,18907.0,,5814.0,,24149,24149,19455,19121,4694,5028,5210208
5365,94013,2799,2799,2140,2164,659,635,2796.0,,2472.0,,324.0,,2570,2570,2085,1917,485,653,5210307
5366,94030,31867,31867,24414,25002,7453,6865,30321.0,,23781.0,,6540.0,,29020,29020,23360,22978,5660,6042,5210406
5367,94056,5345,5345,4417,4313,928,1032,5109.0,,4411.0,,698.0,,5416,5416,4462,4099,954,1317,1710508
5368,94072,5260,5260,4384,4430,876,830,5149.0,,4549.0,,600.0,,5142,5142,4203,4115,939,1027,5210604
5369,94099,4416,4416,3548,3417,868,999,4213.0,,3618.0,,595.0,,4235,4235,3552,3369,683,866,1710706
5370,94110,3658,3658,2851,2848,807,810,3590.0,,3066.0,,524.0,,3522,3522,2719,2594,803,928,5210802
5371,94137,15440,15440,11876,11983,3564,3457,14787.0,,11776.0,,3011.0,,14609,14609,11630,11281,2979,3328,5210901
5372,94153,6721,6721,5193,5246,1528,1475,6713.0,,5612.0,,1101.0,,6499,6499,5313,4951,1186,1548,5211008
5373,94170,2340,2340,1997,1823,343,517,2269.0,,2121.0,,148.0,,1989,1989,1709,1541,280,448,1711100
5374,94196,21640,21640,17616,17790,4024,3850,20887.0,,17085.0,,3802.0,,20611,20611,17120,16502,3491,4109,5211206
5375,94218,4385,4385,3364,3359,1021,1026,4311.0,,3568.0,,743.0,,4144,4144,3263,3174,881,970,5211305
5376,94234,7109,7109,5964,5947,1145,1162,6805.0,,5974.0,,831.0,,6358,6358,5516,5308,842,1050,5211404
5377,94250,74512,74512,56767,58722,17745,15790,72204.0,,54084.0,,18120.0,,71507,71507,56396,55706,15111,15801,5211503
5378,94277,2783,2783,2142,2157,641,626,2746.0,,2484.0,,262.0,,2579,2579,2015,1875,564,704,5211602
5379,94293,5976,5976,4717,4783,1259,1193,5727.0,,4828.0,,899.0,,5596,5596,4656,4431,940,1165,5211701
5380,94315,32246,32246,25985,26232,6261,6014,29900.0,,24208.0,,5692.0,,28980,28980,24312,23773,4668,5207,5211800
5381,94331,71896,71896,54591,56192,17305,15704,68256.0,,46640.0,,21616.0,,68386,68386,52189,51727,16197,16659,5211909
5382,94358,2739,2739,2150,2087,589,652,2790.0,,2445.0,,345.0,,2602,2602,2107,1966,495,636,5212006
5383,94374,5464,5464,4451,4496,1013,968,5345.0,,4676.0,,669.0,,5194,5194,4368,4166,826,1028,5212105
5384,94390,14484,14484,11229,11390,3255,3094,13968.0,,10859.0,,3109.0,,13551,13551,11028,10678,2523,2873,5212204
5385,94439,6628,6628,5201,5257,1427,1371,6195.0,,5225.0,,970.0,,5546,5546,4499,4458,1047,1088,5212303
5386,94455,125775,125775,99917,102275,25858,23500,117695.0,,93218.0,,24477.0,,110991,110991,93075,92549,17916,18442,5212501
5387,94471,2692,2692,2141,2097,551,595,2617.0,,2258.0,,359.0,,2147,2147,1801,1655,346,492,5212600
5388,94498,5963,5963,4608,4649,1355,1314,5851.0,,5087.0,,764.0,,5512,5512,4336,4181,1176,1331,5212709
5389,94510,8237,8237,6421,6415,1816,1822,7936.0,,6636.0,,1300.0,,7703,7703,5938,5673,1765,2030,5212808
5390,94536,2570,2570,2010,2001,560,569,2490.0,,2246.0,,244.0,,2144,2144,1710,1614,434,530,5212907
5391,94552,7024,7024,5415,5457,1609,1567,7046.0,,5796.0,,1250.0,,7087,7087,5697,5510,1390,1577,5216304
5392,94579,7022,7022,5394,5481,1628,1541,7126.0,,5772.0,,1354.0,,7079,7079,5610,5456,1469,1623,5213004
5393,94595,47835,47835,36670,36796,11165,11039,43615.0,,32865.0,,10750.0,,40739,40739,32342,32424,8397,8315,5213103
5394,94617,14101,14101,11311,11025,2790,3076,13906.0,,11489.0,,2417.0,,14367,14367,11275,10542,3092,3825,1713205
5395,94633,9741,9741,7888,7793,1853,1948,9431.0,,7745.0,,1686.0,,9684,9684,7650,7176,2034,2508,1713304
5396,94650,2279,2279,1770,1763,509,516,2340.0,,2150.0,,190.0,,2049,2049,1584,1403,465,646,5213400
5397,94676,5550,5550,4179,4008,1371,1542,5360.0,,4470.0,,890.0,,5223,5223,3935,3619,1288,1604,5213509
5398,94692,4599,4599,3732,3564,867,1035,4440.0,,3801.0,,639.0,,4531,4531,3664,3301,867,1230,1713601
5399,94714,6719,6719,5261,5280,1458,1439,6541.0,,5515.0,,1026.0,,6264,6264,5150,4921,1114,1343,5213707
5400,94730,36278,36278,27771,28299,8507,7979,34819.0,,26574.0,,8245.0,,34248,34248,26774,26299,7474,7949,5213806
5401,94757,4584,4584,3695,3698,889,886,4615.0,,4077.0,,538.0,,4409,4409,3623,3416,786,993,5213905
5402,94773,12396,12396,8878,8870,3518,3526,11504.0,,8650.0,,2854.0,,11120,11120,8352,7734,2768,3386,5214002
5403,94790,3410,3410,2633,2687,777,723,3390.0,,2979.0,,411.0,,3252,3252,2602,2490,650,762,5214101
5404,94811,6575,6575,5234,4977,1341,1598,6305.0,,5283.0,,1022.0,,6300,6300,4958,4418,1342,1882,1714203
5405,94838,4032,4032,3387,3173,645,859,3845.0,,3531.0,,314.0,,3664,3664,3165,2845,499,819,1714302
5406,94854,7285,7285,5693,5764,1592,1521,7044.0,,5909.0,,1135.0,,6656,6656,5466,5258,1190,1398,5214408
5407,94870,24019,24019,18109,18413,5910,5606,22295.0,,17513.0,,4782.0,,21886,21886,16707,16356,5179,5530,5214507
5408,94897,27555,27555,20708,20638,6847,6917,26827.0,,21176.0,,5651.0,,27607,27607,20855,19742,6752,7865,5214606
5409,94919,2472,2472,2057,2027,415,445,2358.0,,2159.0,,199.0,,2099,2099,1763,1681,336,418,5214705
5410,94935,2108,2108,1762,1817,346,291,1970.0,,1865.0,,105.0,,1854,1854,1579,1550,275,304,5214804
5411,94951,2829,2829,2144,2068,685,761,2733.0,,2439.0,,294.0,,2494,2494,1977,1837,517,657,5214903
5412,94978,7946,7946,6237,6422,1709,1524,7643.0,,6440.0,,1203.0,,7113,7113,5837,5744,1276,1369,5215009
5413,94994,3806,3806,3128,2950,678,856,3723.0,,3233.0,,490.0,,3836,3836,2980,2523,856,1313,1715101
5414,95010,3308,3308,2713,2645,595,663,3238.0,,2942.0,,296.0,,3085,3085,2610,2468,475,617,5215207
5415,95036,11941,11941,9409,9594,2532,2347,11825.0,,9442.0,,2383.0,,11649,11649,9454,9306,2195,2343,5215306
5416,95052,3741,3741,3025,3042,716,699,3756.0,,3324.0,,432.0,,3450,3450,2749,2752,701,698,5215405
5417,95079,8700,8700,6964,7079,1736,1621,8039.0,,6891.0,,1148.0,,7425,7425,5967,5889,1458,1536,5215504
5418,95095,18811,18811,14544,14746,4267,4065,17908.0,,14599.0,,3309.0,,17050,17050,13960,13530,3090,3520,5215603
5419,95117,21968,21968,16930,17112,5038,4856,21033.0,,16088.0,,4945.0,,20208,20208,15733,15335,4475,4873,5215702
5420,95133,2199,2199,1805,1774,394,425,2161.0,,1940.0,,221.0,,2106,2106,1705,1629,401,477,5215801
5421,95150,4078,4078,3280,3298,798,780,4161.0,,3720.0,,441.0,,3686,3686,3021,2918,665,768,5215900
5422,95176,2608,2608,1961,2006,647,602,2642.0,,2221.0,,421.0,,2416,2416,1854,1785,562,631,5216007
5423,95192,33177,33177,26867,26849,6310,6328,31221.0,,24047.0,,7174.0,,33107,33107,25635,24514,7472,8593,1716109
5424,95214,7934,7934,6003,5789,1931,2145,7626.0,,6462.0,,1164.0,,7740,7740,5716,5236,2024,2504,1716208
5425,95230,8981,8981,6621,6858,2360,2123,8666.0,,6652.0,,2014.0,,8428,8428,6593,6377,1835,2051,5216403
5426,95257,9872,9872,7986,7803,1886,2069,9469.0,,7741.0,,1728.0,,9553,9553,7414,6965,2139,2588,1716505
5427,95273,7059,7059,5587,5372,1472,1687,7008.0,,5899.0,,1109.0,,6979,6979,5467,5072,1512,1907,1716604
5428,95290,6402,6402,5203,5050,1199,1352,6192.0,,5225.0,,967.0,,6220,6220,5036,4734,1184,1486,1716703
5429,95311,7398,7398,5738,5812,1660,1586,7177.0,,6006.0,,1171.0,,7044,7044,5839,5665,1205,1379,5216809
5430,95338,8132,8132,6647,6368,1485,1764,7589.0,,6603.0,,986.0,,7498,7498,6305,5799,1193,1699,1709005
5431,95354,3669,3669,2847,2692,822,977,3626.0,,3332.0,,294.0,,2841,2841,2363,2094,478,747,5216908
5432,95370,3574,3574,2905,2789,669,785,3519.0,,3175.0,,344.0,,3319,3319,2786,2471,533,848,1717008
5433,95397,18894,18894,14080,14514,4814,4380,18534.0,,13592.0,,4942.0,,18851,18851,14550,14217,4301,4634,5217104
5434,95419,9311,9311,7257,7427,2054,1884,9156.0,,7308.0,,1848.0,,9182,9182,7180,6957,2002,2225,5217203
5435,95435,19985,19985,15811,16012,4174,3973,18846.0,,15345.0,,3501.0,,18029,18029,14942,14756,3087,3273,5217302
5436,95451,21791,21791,16634,16970,5157,4821,21067.0,,16447.0,,4620.0,,20235,20235,16615,16330,3620,3905,5217401
5437,95478,5832,5832,4602,4354,1230,1478,5476.0,,4762.0,,714.0,,5331,5331,4207,3553,1124,1778,1717503
5438,95494,14230,14230,11398,11440,2832,2790,13695.0,,11081.0,,2614.0,,13407,13407,11024,10729,2383,2678,5217708
5439,95516,3401,3401,2683,2629,718,772,3308.0,,2851.0,,457.0,,3352,3352,2565,2398,787,954,1717800
5440,95532,5365,5365,4300,4120,1065,1245,5114.0,,4407.0,,707.0,,5025,5025,3969,3624,1056,1401,1717909
5441,95559,31009,31009,23754,23951,7255,7058,29782.0,,23050.0,,6732.0,,29475,29475,23365,22778,6110,6697,5218003
5442,95575,3156,3156,2460,2506,696,650,3117.0,,2667.0,,450.0,,3055,3055,2443,2447,612,608,5218102
5443,95591,42885,42885,35587,35167,7298,7718,40319.0,,32899.0,,7420.0,,40317,40317,32845,31200,7472,9117,1718204
5444,95613,24385,24385,19240,19436,5145,4949,23054.0,,18679.0,,4375.0,,22220,22220,18644,17775,3576,4445,5218300
5445,95630,34503,34503,27066,27740,7437,6763,33569.0,,27295.0,,6274.0,,31671,31671,26137,25798,5534,5873,5218508
5446,95656,8956,8956,7051,7142,1905,1814,8562.0,,7025.0,,1537.0,,8253,8253,6768,6610,1485,1643,5218607
5447,95672,3816,3816,3077,3046,739,770,3678.0,,3129.0,,549.0,,3654,3654,2963,2845,691,809,5218706
5448,95699,2961,2961,2364,1990,597,971,2914.0,,2623.0,,291.0,,2902,2902,2247,1753,655,1149,1712405
5449,95710,142441,142441,112068,114805,30373,27636,132809.0,,96573.0,,36236.0,,128948,128948,102914,102724,26034,26224,5218805
5450,95737,15267,15267,12095,12129,3172,3138,14700.0,,12094.0,,2606.0,,14511,14511,12020,11707,2491,2804,5218904
5451,95753,7053,7053,5612,5658,1441,1395,6746.0,,5580.0,,1166.0,,6422,6422,5476,5250,946,1172,5219001
5452,95770,5371,5371,4256,4252,1115,1119,5213.0,,4458.0,,755.0,,5065,5065,4224,4077,841,988,5219100
5453,95796,3217,3217,2514,2453,703,764,3146.0,,2785.0,,361.0,,2652,2652,2145,1994,507,658,5219209
5454,95818,29477,29477,23311,23936,6166,5541,28721.0,,21915.0,,6806.0,,28338,28338,23089,22792,5249,5546,5219308
5455,95834,4430,4430,3264,3299,1166,1131,4280.0,,3385.0,,895.0,,3949,3949,3174,3096,775,853,5219407
5456,95850,3096,3096,2606,2608,490,488,3029.0,,2732.0,,297.0,,2718,2718,2379,2273,339,445,5219506
5457,95877,3179,3179,2394,2394,785,785,3223.0,,2755.0,,468.0,,2959,2959,2249,2184,710,775,5219605
5458,95893,7621,7621,5980,5940,1641,1681,7232.0,,6171.0,,1061.0,,6869,6869,5773,5507,1096,1362,5219704
5459,95915,7119,7119,5257,5206,1862,1913,6956.0,,5724.0,,1232.0,,6589,6589,5107,4735,1482,1854,5219803
5460,95931,4706,4706,3798,3797,908,909,4371.0,,3782.0,,589.0,,4149,4149,3535,3494,614,655,5219902
5461,95958,61018,61018,47412,48669,13606,12349,56712.0,,43758.0,,12954.0,,54167,54167,43634,44450,10533,9717,5217609
5462,95974,7040,7040,5481,5524,1559,1516,6486.0,,5332.0,,1154.0,,6046,6046,4912,4816,1134,1230,5220009
5463,95990,24067,24067,18754,19305,5313,4762,22902.0,,18312.0,,4590.0,,22789,22789,18510,18138,4279,4651,5220108
5464,96016,18361,18361,13773,13762,4588,4599,18071.0,,14058.0,,4013.0,,16982,16982,13554,12776,3428,4206,5220207
5465,96032,3196,3196,2582,2490,614,706,3039.0,,2671.0,,368.0,,2931,2931,2448,2342,483,589,1720309
5466,96059,13838,13838,10344,10494,3494,3344,13560.0,,10974.0,,2586.0,,13489,13489,10570,10453,2919,3036,5220405
5467,96075,6282,6282,4692,4806,1590,1476,5882.0,,4554.0,,1328.0,,5920,5920,4357,4385,1563,1535,5220504
5468,96091,15622,15622,12556,12807,3066,2815,15088.0,,12046.0,,3042.0,,14817,14817,12222,12015,2595,2802,5220603
5469,96113,3164,3164,2165,2091,999,1073,3294.0,,2872.0,,422.0,,2821,2821,1992,1761,829,1060,5220702
5470,96130,7694,7694,6366,6193,1328,1501,7248.0,,6198.0,,1050.0,,7141,7141,6204,5918,937,1223,1720804
5471,96156,10437,10437,8205,8101,2232,2336,9884.0,,7869.0,,2015.0,,10425,10425,7756,7476,2669,2949,1720903
5472,96172,4559,4559,3502,3532,1057,1027,4624.0,,3943.0,,681.0,,4349,4349,3334,3161,1015,1188,5221007
5473,96199,4874,4874,4109,4036,765,838,4606.0,,4158.0,,448.0,,4734,4734,3981,3722,753,1012,1721109
5474,96210,15745,15745,13083,12975,2662,2770,14783.0,,12578.0,,2205.0,,14496,14496,12213,11829,2283,2667,1721208
5475,96237,3608,3608,2815,2835,793,773,3669.0,,3175.0,,494.0,,3499,3499,2645,2563,854,936,5221304
5476,96253,89447,89447,69775,71193,19672,18254,84176.0,,64282.0,,19894.0,,81150,81150,63881,62922,17269,18228,5221403
5477,96270,16844,16844,13782,13590,3062,3254,16004.0,,12838.0,,3166.0,,16575,16575,13021,12383,3554,4192,1709302
5478,96296,2676,2676,2233,2139,443,537,2658.0,,2401.0,,257.0,,2655,2655,2105,1929,550,726,1718402
5479,96318,4730,4730,3753,3773,977,957,4804.0,,4078.0,,726.0,,4496,4496,3625,3378,871,1118,5221502
5480,96334,29135,29135,22351,22614,6784,6521,27779.0,,21627.0,,6152.0,,27362,27362,21298,20814,6064,6548,5221601
5481,96350,10411,10411,8343,8467,2068,1944,10203.0,,8651.0,,1552.0,,9328,9328,7715,7596,1613,1732,5221700
5482,96377,3401,3401,2717,2665,684,736,3243.0,,2937.0,,306.0,,2799,2799,2384,2269,415,530,5221809
5483,96393,3839,3839,2916,2980,923,859,3889.0,,3218.0,,671.0,,3573,3573,2716,2616,857,957,5221908
5484,96415,10663,10663,8557,8777,2106,1886,10244.0,,8401.0,,1843.0,,10006,10006,8277,8202,1729,1804,5222005
5485,96431,8371,8371,6742,6673,1629,1698,8108.0,,6814.0,,1294.0,,8262,8262,6718,6218,1544,2044,1722107
5486,96458,15186,15186,11834,12160,3352,3026,14422.0,,11677.0,,2745.0,,13680,13680,11322,11097,2358,2583,5200134
5487,96474,22527,22527,16736,16824,5791,5703,21829.0,,17017.0,,4812.0,,21354,21354,16782,15815,4572,5539,5213087
5488,96490,5526,5526,4496,4461,1030,1065,5181.0,,4527.0,,654.0,,5354,5354,4278,4031,1076,1323,1715754
5489,96512,4868,4868,3721,3717,1147,1151,4790.0,,4038.0,,752.0,,4397,4397,3639,3379,758,1018,5214051
5490,96539,9084,9084,6650,6499,2434,2585,8904.0,,7146.0,,1758.0,,8773,8773,6675,6052,2098,2721,5214838
5491,96555,6665,6665,5391,5461,1274,1204,6442.0,,5527.0,,915.0,,6245,6245,5253,5007,992,1238,5214861
5492,96571,6305,6305,5187,5186,1118,1119,6001.0,,5249.0,,752.0,,5599,5599,4782,4585,817,1014,5222054
5493,96598,4486,4486,3637,3530,849,956,4434.0,,3875.0,,559.0,,4205,4205,3484,3172,721,1033,1720655
5494,96610,5200,5200,4179,4192,1021,1008,5036.0,,4439.0,,597.0,,4454,4454,3906,3717,548,737,5200852
5495,96636,7822,7822,6434,6395,1388,1427,7400.0,,6405.0,,995.0,,7577,7577,6333,6131,1244,1446,1714880
5496,96652,6904,6904,5548,5375,1356,1529,6573.0,,5535.0,,1038.0,,6512,6512,5305,5000,1207,1512,1722081
5497,96679,4445,4445,3620,3542,825,903,4293.0,,3717.0,,576.0,,4173,4173,3316,3051,857,1122,1707652
5498,96695,6051,6051,4617,4521,1434,1530,6120.0,,5141.0,,979.0,,5972,5972,4587,4256,1385,1716,5202155
5499,96717,3310,3310,2656,2601,654,709,3264.0,,2945.0,,319.0,,3054,3054,2455,2303,599,751,5202353
5500,96733,7126,7126,5442,5574,1684,1552,7059.0,,5745.0,,1314.0,,7028,7028,5211,5124,1817,1904,5204250
5501,96750,5755,5755,4524,4594,1231,1161,5848.0,,4964.0,,884.0,,5955,5955,4787,4580,1168,1375,5207253
5502,96776,43084,43084,34037,34241,9047,8843,41021.0,,32122.0,,8899.0,,39482,39482,30993,30692,8489,8790,5219753
5503,96792,4056,4056,3458,3257,598,799,4063.0,,3745.0,,318.0,,3772,3772,3056,2714,716,1058,1718758
5504,96814,11729,11729,9030,9245,2699,2484,11264.0,,8643.0,,2621.0,,10598,10598,8511,8523,2087,2075,5209952
5505,96830,3195,3195,2621,2523,574,672,3163.0,,2839.0,,324.0,,2951,2951,2414,2207,537,744,1707553
5506,96857,12523,12523,10103,9988,2420,2535,11733.0,,9801.0,,1932.0,,11985,11985,9720,9440,2265,2545,1702554
5507,96873,3507,3507,2737,2665,770,842,3517.0,,3274.0,,243.0,,2729,2729,2271,2082,458,647,5204656
5508,96890,3706,3706,2949,2935,757,771,3687.0,,3320.0,,367.0,,3348,3348,2717,2581,631,767,5219357
5509,96911,2796,2796,2232,2208,564,588,2780.0,,2557.0,,223.0,,2314,2314,2019,1900,295,414,5200159
5510,96938,4631,4631,3491,3540,1140,1091,4586.0,,3978.0,,608.0,,4333,4333,3335,3096,998,1237,5200175
5511,96954,4206,4206,3341,3241,865,965,4013.0,,3348.0,,665.0,,4096,4096,3193,2903,903,1193,1700350
5512,96970,3907,3907,3358,3303,549,604,3715.0,,3365.0,,350.0,,3549,3549,2887,2679,662,870,1701101
5513,96997,4465,4465,3664,3650,801,815,4379.0,,3742.0,,637.0,,4334,4334,3596,3281,738,1053,1703107
5514,98019,6660,6660,5134,4970,1526,1690,6663.0,,5264.0,,1399.0,,6618,6618,4894,4567,1724,2051,5002159
5515,98035,22565,22565,16129,16152,6436,6413,22377.0,,16429.0,,5948.0,,20380,20380,14606,14174,5774,6206,5003256
5516,98051,4701,4701,4081,4077,620,624,4654.0,,4211.0,,443.0,,4177,4177,3507,3459,670,718,5003504
5517,98078,14287,14287,10281,10201,4006,4086,13791.0,,10479.0,,3312.0,,13793,13793,9841,9297,3952,4496,5004601
5518,98094,21720,21720,16556,16601,5164,5119,20554.0,,14755.0,,5799.0,,19657,19657,14825,14488,4832,5169,5007695
5519,98116,6780,6780,5175,4994,1605,1786,6670.0,,5708.0,,962.0,,6054,6054,4451,4195,1603,1859,5007802
5520,98132,7324,7324,5600,5595,1724,1729,6965.0,,5316.0,,1649.0,,7050,7050,5454,5321,1596,1729,5007703
5521,98159,6707,6707,4901,4838,1806,1869,6644.0,,5058.0,,1586.0,,7096,7096,5049,4813,2047,2283,5007950
5522,98175,3541,3541,2815,2827,726,714,3429.0,,2971.0,,458.0,,3198,3198,2487,2385,711,813,5007976
5523,98191,24430,24430,17747,18425,6683,6005,23748.0,,16937.0,,6811.0,,23474,23474,16450,16170,7024,7304,5105101
5524,98213,25045,25045,21227,20704,3818,4341,24423.0,,20782.0,,3641.0,,23714,23714,20712,20488,3002,3226,4321451
5525,98230,10275,10275,8906,8987,1369,1288,10062.0,,8769.0,,1293.0,,9895,9895,8696,8680,1199,1215,4302352
5526,98256,39540,39540,32641,32829,6899,6711,39045.0,,31486.0,,7559.0,,38834,38834,32708,32280,6126,6554,4314050
5527,98272,3714,3714,3257,3245,457,469,3644.0,,3210.0,,434.0,,3545,3545,3164,3128,381,417,4308458
5528,98299,6162,6162,5289,5312,873,850,6085.0,,5347.0,,738.0,,6054,6054,5231,5222,823,832,4311155
5529,98310,33413,33413,24011,24717,9402,8696,31878.0,,22111.0,,9767.0,,31487,31487,22284,22007,9203,9480,5105150
5530,98337,5626,5626,4508,4515,1118,1111,5546.0,,4572.0,,974.0,,5559,5559,4194,4014,1365,1545,5103452
5531,98353,36599,36599,30850,29360,5749,7239,33873.0,,29222.0,,4651.0,,30612,30612,26306,25178,4306,5434,1301852
5532,98370,7423,7423,5171,5134,2252,2289,7004.0,,5744.0,,1260.0,,6789,6789,4578,4593,2211,2196,1301951
5533,98396,14599,14599,10978,10004,3621,4595,13908.0,,11413.0,,2495.0,,13165,13165,9807,8471,3358,4694,1302553
5534,98418,25306,25306,18554,17779,6752,7527,23650.0,,18903.0,,4747.0,,22739,22739,17052,16143,5687,6596,1303536
5535,98434,18180,18180,14421,13527,3759,4653,16698.0,,13699.0,,2999.0,,15129,15129,11775,10904,3354,4225,1303569
5536,98450,7358,7358,5645,5100,1713,2258,6984.0,,6048.0,,936.0,,6644,6644,4894,4573,1750,2071,1303957
5537,98477,37078,37078,27583,27693,9495,9385,34909.0,,27702.0,,7207.0,,33212,33212,25458,24752,7754,8460,1304062
5538,98493,8944,8944,6753,6342,2191,2602,8177.0,,6931.0,,1246.0,,7371,7371,5398,5141,1973,2230,1304260
5539,98515,10593,10593,8142,8000,2451,2593,9904.0,,8578.0,,1326.0,,9227,9227,6854,6787,2373,2440,1304237
5540,98531,14193,14193,12308,12347,1885,1846,13287.0,,11974.0,,1313.0,,12727,12727,11171,11105,1556,1622,2311355
5541,98558,15246,15246,12476,12265,2770,2981,14486.0,,12740.0,,1746.0,,13932,13932,12124,11420,1808,2512,2313757
5542,98574,16794,16794,12887,12890,3907,3904,16437.0,,13726.0,,2711.0,,15563,15563,11354,10907,4209,4656,2313955
5543,98590,11694,11694,9200,9119,2494,2575,11157.0,,9053.0,,2104.0,,10342,10342,7981,7455,2361,2887,5003157
5544,98612,7411,7411,5477,5458,1934,1953,7074.0,,5509.0,,1565.0,,6890,6890,4736,4573,2154,2317,5100607
5545,98639,3171,3171,2337,2345,834,826,3119.0,,2633.0,,486.0,,2839,2839,2076,1986,763,853,5101001
5546,98655,10214,10214,7419,7555,2795,2659,9676.0,,7494.0,,2182.0,,9496,9496,6806,6509,2690,2987,5102603
5547,98671,4815,4815,3231,3198,1584,1617,4762.0,,3812.0,,950.0,,4341,4341,2849,2593,1492,1748,5103106
5548,98698,4232,4232,2976,3030,1256,1202,4189.0,,3207.0,,982.0,,4138,4138,2766,2688,1372,1450,5104559
5549,98710,8933,8933,6222,6510,2711,2423,8870.0,,6311.0,,2559.0,,9054,9054,6205,5993,2849,3061,5105580
5550,98736,12517,12517,9409,9560,3108,2957,12535.0,,9574.0,,2961.0,,11686,11686,8618,8386,3068,3300,5106232
5551,98752,10000,10000,7216,7365,2784,2635,9829.0,,7133.0,,2696.0,,10183,10183,7258,7132,2925,3051,5106216
5552,98779,5324,5324,3901,3976,1423,1348,5105.0,,4103.0,,1002.0,,5066,5066,3459,3266,1607,1800,5106281
5553,98795,3111,3111,2323,2423,788,688,3128.0,,2534.0,,594.0,,3146,3146,2268,2285,878,861,5106273
5554,98817,22857,22857,16817,17137,6040,5720,22057.0,,16348.0,,5709.0,,19699,19699,14337,14026,5362,5673,5106422
5555,98833,9190,9190,6894,7151,2296,2039,8964.0,,6868.0,,2096.0,,8708,8708,6150,6090,2558,2618,5106299
5556,98850,8281,8281,5731,5735,2550,2546,8082.0,,5944.0,,2138.0,,7403,7403,5014,4690,2389,2713,5106778
5557,98876,7726,7726,5606,5503,2120,2223,7533.0,,5716.0,,1817.0,,7799,7799,5540,5253,2259,2546,5106828
5558,98892,50025,50025,39105,39864,10920,10161,45290.0,,32224.0,,13066.0,,43809,43809,33931,33364,9878,10445,5107040
5559,98914,1948,1948,1381,1364,567,584,1913.0,,1575.0,,338.0,,2000,2000,1438,1355,562,645,5107156
5560,98930,67362,67362,52318,53852,15044,13510,60978.0,,43665.0,,17313.0,,55226,55226,42194,41920,13032,13306,5107925
5561,98957,8656,8656,6331,6500,2325,2156,8503.0,,6339.0,,2164.0,,8679,8679,6217,6071,2462,2608,5108055
5562,98973,7162,7162,5316,5468,1846,1694,6963.0,,5080.0,,1883.0,,6292,6292,4516,4466,1776,1826,5108501
5563,98990,14314,14314,9854,10114,4460,4200,13884.0,,9871.0,,4013.0,,13220,13220,8717,8363,4503,4857,5108600
5564,99015,14269,14269,10148,10192,4121,4077,14222.0,,10483.0,,3739.0,,13817,13817,9659,9204,4158,4613,5103304
5565,99031,3025,3025,2175,2226,850,799,3085.0,,2536.0,,549.0,,3099,3099,2301,2166,798,933,5103809
5566,99058,22630,22630,16368,17029,6262,5601,21860.0,,14895.0,,6965.0,,21406,21406,15021,14745,6385,6661,5104104
5567,99074,1926,1926,1513,1488,413,438,1902.0,,1623.0,,279.0,,1865,1865,1456,1406,409,459,5104500
